JJJJJJJJJJJJJJGGGGGGGGGGGDAAAAAAAAAAADDDAAAADGGGGG
JJJJGJJJJJJJJJGGGGGGGGGGGDAAAAAAAAAAAAAAAAAADDDGGG
JJJJJGJJJJJJJGGGGGGGGGGGGDAAAAAAAAAAAAAAAAAAADDDGG
JJJJJGGGJJJJGGGGGGGGGGGGDDAAAAAAAAAAAAAAAAAAADDDGG
JJJJJGGGJGGGGGGGGGGGGGGGDAAAAAAAAAAAAAAAAAAAAAAADG
JJJJJGGGGGGGGGGGGGGGGGGGAAAAAAAAAAAAAAAAAAAAAAAADG
JJJJGGGGGGGGGGGGGGGGGGDDAAAAAAAAAAAAAAAAAAAAAAAADG
JJJGGGGGGGGGGGGGGGGGGDAAAAAAAAAAAAAAAAAAAAAAAAADDD
JGGGGGGGGGGGGGGGGGGDDAAAAAAAAAAAAAAAAAAAAAAAAADDDD
GGGGGGGGGGGGGGGGGGGDAAAAAAAAAAAAAAAAAAAAAAAAAAADDD
GGGGGGGGGGDDDGGGDAAAAAAAAAAAAAAAAAAAAAAAAAAAAAAAAA
GGGGGGGGGGGGDGGGDDAAAAAAAAAAAAAAAAAAAAAAAAAAAAAAAA
GGGGGGGGGGGGDDDDDDAAAAAAAAAAAAAAAAAAAAAAAAAAAAAAAA
GGGGGGGDGDDDDDDGGDAAAAAAAAAAAAAAAAAAAAAAAAAAAAAAAA
GGGGGGGDDDDDDDDDDDAAAAAAAAAAAAAAAAAAAAAAAAAAAAAAAA
GGGGGGGDDDDDDDDDDDAAAAAAAADDAAAAAAAAAAAAAAAAAAAAAA
GGGGGGDDDDDDDDDDGGDAAADDDDDDDAAAAAAAAAAAAAAAAAAAAA
GGGGGGDDDDDDDDDGGGGDDDDGGGGGGDDAAAAAAAAAAAAAAAAAAA
GGGGGGGGDDDDDDDDGGGDDDGGGGGGGDGDAAAAAAAAAAAAAAAADD
GGGGGGGGDGDDDDDGGGGGGGGGGGGGGGGDDAAAAAAAAAAAAADDDD
JJGGGGGGGGGDDDDDGGGGGGGGGGGGGGGGDDAAAAAAAAAAAADGGD
GGGGGGGGGGGGGGGGGGGGGGGGGGGGGGGGGGGAAAAAAADDAADGGG
GGGGGGGGGGGGGGGGGGGGGGGGGGGJJJJJGGGDDAAAADDGDDGGGG
GGGGGGGGGGGGGGGGGGGGGGGGGGGGJJJJJJGGGDDDGGGGGGGGGG
GGGGGGGGGGGGGGGGGGGGGGGGGJJJJJJJJJGGGGGGGGGGGGGGGG
GGGGGGGGGGGGGGGGGGGGGGGGJJJJJJJJJJJJGGGGGGGGGGGGGG
GGGGGGJJJJJJGGGGGGGGGGJJJJJJJJJJJJJJJJGGGGGGGGGGGG
GGGGGJJJJJJJJJJGGGGGJJJJJJJJMJJJJJJJJJJJJJJGGGGGJJ
JJJGJJJJJJJJJJJJGGGGJJJJJJJJJJMJJJJJJJJJJJJGGGJJJJ
JJJJJJJJJJJJJJJJJJGJJJJJJJJJMMMMMJMJJJJJJJJGGGJJJG
JJJJJJJJJJJJJJJJJJJJJJJJJJJJMJMMMMMMMJJJJJJJGGGJJG
JJJJJJJJJJJJJJJJJJJJJJJJJJJJJMMMMMMMMMJJJJJJJJJGJJ
JJJJJJJJJJJJJJJJJJJJJJJJJJJMMMMMMMMMMJJJJJJJJJJJJJ
JJJJJJJJJJJJJJJJJJJJJJJJJJJMMMPMMMMMMMJJJJJJJJJJJJ
JJJJJJJJJJJJJJJJJJJJJJJJJJMMMMMMMMMMMJJJMMJJJJJJJJ
JJJJJJJJJJJJJJJJJJJJJJJJJMJMMMMMMMMMMJJJMMMMJJJJJJ
JJJJJJJJJJJJJJJJJJJJJJJJMJMMMMMMMMMMMMMMMMJMJJJJJJ
JJJJJJJJJJJJJJJJJJJJJJJJJJJMMPMMJMMMMMMMMMMJJJJJJJ
JJJJJJJJJJJJJJJJJJJJJJJJJJJJMMMJMJJJJMMMMMJJMJJJJJ
GJJGJJJJJJJJJJJJJJJJJJJJJJJJMMMMJJJJJMMMMMMMMJJMJJ
GGGGJJJJJJJJJJJJJJJJJJJJJJJJMMJJJMMMMMMMMMMMMMMMJJ
GGGGJJJJJJJJJJJJJJJJJJJJJJJJJJJJJJMMMMMMMMMMMMMMJJ
GGGGGJJJJJJJJJJJJJJJJJJJJJJJJJMJJJJMMPPPPMMMMMMMMJ
GGGGGGJJJJJJJJJJJJJJJJJJJJJJJJMJMMMMMMMPPPMMMMMMJJ
GGGGGGGJJJJJJJJJJJJJJJJJJJJJMMMMMMPMPPPMPPPMMMMMMJ
GGGGGGGJJJJJJJJJJJJJJJJJJJJJMMJJMPPMMPMMPPPMMMMJMJ
GGGGGGJJJJJJJJJJJJJJJJJJJJJMJMMJPMPPMPMMPPPPMMMJJJ
GGGGGGJJJJJJJJJJJJJJJJJJJJMMMMMJMMMPPMMPMPPPMMJJJJ
GGGGGJJJJJJJJJJJJJJJJJJJJJJMJMMMMMJMMPPPPMMMMMJJJJ
GGGGJJJJJJJJJJJJJJJJJJMJJJJJJMMJMMMMMMMPPMPMMMJJJJ
