AAAAAAAAAAAAAAAAAAAAADDDGGGGGDDGGGGGGGAAAAAAAAAAAA
AAAAAAAAAAAAAAAAAAAAAAADDDDDDDDGGGGDDDAAAAAAAAAAAA
AAAAAAAAAAAAAAAAAAAAAAAADDDDDDDGDGDDDAAAAAAAAAAAAA
AAAAAAAAAAAAAAAAAAAAAAAADGDDDDDDDDDDDAAAAAAAAAAAAA
AAAAAAAAAAAAAAAAAAAAAAAADDDDDDDDDDDDAAAAAAAAAAAAAA
AAAAAAAAAAAAAAAAAAAAAAAAAADDDDDDDDDDAAAAAAAAAAAAAA
AAAAAAAAAAAAAAAAAAAAAAAAAAADDDDDDDGGDAAAAAAAAAAAAA
AAAAAAAAAAAAAAAAAAAAAAAAAAAADDDDDDGGGDADAAAAAAAAAA
AAAAAAAAAAAAAAAAAAAAAAAAAAAAAADDDGGGGGDDAAADDDDDDA
AAAAAAAAAAAAAAAAAAAAAAAAAAAAAADDGGGGGGDDAADGGGGGDA
AAAAAAAAAAAAAAAAAAAAAAAAAAAAADDDGGGGGGDDDDDGGGGGGG
AAAAAAAAAAAAAAAAAAAAAAAAAAAADDDDGGGGGGGGDDDGGGGGGG
DAAAAAAAAAAAAAAAAAAAAAAAAAAADDDDGGGGGGGGGGGGGGGGGG
DDDAAAAAAAAAAAAAAAAAAAAAAAAAAAADGGGGGGGGGGGGGGGGGG
DDDDDDDAAAAAAAAAAAAAAAAAAAAAAAADDGGGGGGGGGGGGGGGGG
GGGGGGGGDDAAAAAAAAAAAAAAAAAAAAADDGGGGGGGGGGGGGGGGJ
GGGGGGGGGGGAAAAAAAAAAAAAAAAAAADDDGGGGGGGGGGGGGGJGJ
GGGGGGGGGGGDDAAAAAAAAAAAAAAADDDDDDGGGGGGGGGGGGGJJJ
GGGGGGGGGGGGDDAAAAAADDGDDDDDDDDGGGGGGGGGGGGGGGGGJJ
JGGGGGGGGGGGGDDAAAADGGGGGGGGGGGGGGGGGGGGGGGGGJGGGG
JJJJJJGGGGGGGGGGDDDDGGGGGGGGGGGGGGGJJGGGGGGGGGGGGG
JJJJJJJJGGGGGGGGGGGGGGGGGJGGGGGGJGGJJJJJJGGGGGGGGJ
JJJJJJJJGGGGGGGGGGGGGGGGJJGJJGGGJJJJJJJJJJJGGGJJJJ
JJJJJJJJJJGGGGGGGGGGGGGGJJJJJJJJJJJJJJJJJJJJJJJJJJ
JJJJJJJJJJJGGGGGGGGGGGGGJJJGGGGJJJJJJJJJJJJJJJJJJJ
JJJJJJJJJJJGGGGGGGGGGGGGGGGGGGGGGJJJJJJJJJJJJJJJJJ
JJJMJJJJJJJJGGGGGGGGGJJJJGGGJJJJJGJJJJJJJJJJJJJJJJ
JMMMMMJJJJJJJGGGGGGJJJJJJJJJJJJJJJJJJJJJJJJJJJJJJG
MMMMJMMMJJJJJJJGGGJJJJJJJJJJJJJJJJJJJJJJJJJJJJJJJG
MMMMMMMMMMJJJJJJGJJJJJJJJJJJJJJJJJJJJJJJJJJJJJJJJG
MMMMMMMMMMMJJJJJJJJJJJJJJJJJJJJJJJJJJJJJJJJJJJJJJG
MMMMMMMMMJMJJJJJJJJJJJJJJJJJJJJJJJJJJJJGGGGGJJJJJG
MMMMMMMMMJJJJJJJJJJJJJJJJJJJJJJJJJJJJJGGGGGGGGGGGG
PMMMMMMMMJJJJJJJJJJJJJJJJJJJJJJJJGGGGGGGGGGGGGGGGG
MMMMMMMJMMJJJJJJJJJJJJJJJJJJJJJJJGGGGJJJJJGGGGGGGG
MMMMMMMMMMJJJJJJJJJJJJJJJJJJJJJGGGGGGJJJJJGGGGGGGG
MMMMMMMMMJJJJJJJJJJJJJJJJJJJJJJJGGGGGGGGJJJGGGJJGG
MMMMMMMMMMJJJJJJJJJJJJJJJJJJJJJJJGGGGGGGJGGGGGJGGG
PMMMMMMMMMJJJJJJJJJJJJJJJJJJJJJJJGGGGJJGGJGGGGGGGG
MMMMMMMMMJJJJJJJJJJJJJJJJJJJJJJJJGGGGGJGGJGGGJGGGG
MMMMMMMMMJJJJJJJJJJJJJJJJJJJJJJJGGGGGJJGJJGGGGJJGG
MMMMMMMMMJJJJJJJJJJJJJJJJJJJJJJJGGGGGGGJJGGGGJJJJG
PMMMMMMMMJJJJJJJJJJJJJJJJJJJJJJJGGGGGGGJJGGGJGJJGG
PPPPPMMMMJJJJJJJJJJJJJJJJJJJJJJJGGGGGGGJGGGJJGJJJG
PPPPPPMMMMJJJMJJJJJJJJJJJJJJJJJJJGGGGGGGGJJJJJJJJJ
PPPPPPPMMMJJJMJJJJJJJJJJJJJJJJJJJJGGGGGGGGJGGJJJJG
PPPPPPPPMMMJJMJJJJJJJJJJJJJJJJJJJJJGGGGGGGGGGGJGGG
MPPPPPPMMMMMMJJJJJJJJJJJJJJJJJJJJJJGGGGJGGGGGGGGGG
PMMPPPPPMMMMMMMJJJJJJJJJJJJJJJJJJGGGGGJJJJJJJJJGGG
PPPPMPMMMJMJMMMJJJJJJJJJJJJJJJJJJGGGGJGGJJJJJJJJGG
