JJJJJJJJMJMMJJJJJJJJJJJJJJJJJJGGGGDDDAAAAAAAAAAAAA
JJJJJJJMMMJJJJJJJJJJJJJJJGGJJGGGGGGDDDAAAAAAAAAAAA
JJJJJJJJMMMJMMMJJJJJJJJJGGGGGGGGGGGGDAAAAAAAAAAAAA
JJJJJJJJMMJJMJJJJJJJJJJJGGGGGGGGGGGDAAAAAAAAAAAAAA
JJJJJJMMMMMJJJJJJJJJJJJJJGGGGGJGGGDAAAAAAAAAAAAAAA
JJJJJJMMMMMMMJJJJJJJJJJJGGGGGJJGGGDAAAAAAAAAAAAAAA
JJJJJMMMMMMMMJJJJJJJJJJJGJGGGGJGGGGDAAAAAAAAAAAAAA
JJJJJJJJMMMMMJJJJJJJJJJJJJGGGJGGGGGDAAAAAAAAAAAAAA
JJJJJJJMMMMMJJJJJJJJJJJJJJJGGGGGGGGDAAAAAAAAAAAAAA
JJJJJJJJMMJJJJJJJJJJJJJJJJJGJGGGGGDAAAAAAAAAAAAAAA
JJJJJJJJJJJJJJJJJJJJJJJJJGGGGGGGGDAAAAAAAAAAAAAAAA
JJJJJJJJJJJJJJJJJJJJJJJJJGGGGGGGGDAAAAAAAAAAAAAAAA
JJJJJMJJJJJJJJJJJJJJJJJJJJGGGGGGDAAAAAAAAAAAAAAAAA
JJJJJMJJJJJJJJJJJJJJJJJJJJGGGGGGGAAAAAAAAAAAAAAAAA
JJJJJJJJJJJJJJJJJJJJJJJJJJGGGGGGDAAAAAAAAAAAAAAAAA
JJJJJJJJJJJJJJJJJJJJJJJJJJJJJGGGGAAAAAAAAAAAAAAAAA
JJJJJJJJJJJJJJJJJJJJJJJJJJJJJJGGGDAAAAAAAAAAAAAAAA
JJJJJJJJJJJJJJJJJJJJJJJJJJJJJJGGGGDDDAAAAAAAAAAAAA
JJJJJJJJJJJJGJJJJJJJJJJJJJJJJJGGGGGDDAAAAAAAAAAAAA
JJJJJJJJJJJJJJJJJJJJJGJJJJJJJJGGGGGDDDDAAAAAAAAAAA
JJJJJJJJJJJJJJJJJJJJJJGJJJJJJGGGGGGDDDDAAAAAAAAAAA
JJJJJJJJJJJJJJJJJJJJJJJJJJJJGGGGGGGGDDDAAAAAAAAAAA
JJJJJJJJJJJJJJJJJJJGJJJJJJJJJJJGGGGGGGGDAAAAAAAAAD
JJJJJJJJJJJJJJJJJJJGGJJJJJJJJJJJGGGGGGGDDAAAAAADGG
JJJJJJJJJJJJJJJJJJGGGJJJJJJJJJJJGGGGJGGDDDDAAADGGG
JJJJJJJJJJJJJJJJJJGGJJJJJJJJJJJJJGGJJGGGGGGGDDGGGG
JGJGGJJJJJJMMJJMJJJJJJJJJJJJJJJJJJJJJJGGGGGGGGGGGG
JGGGJJJJJJMMMMJMJJJJJJJJJJJJJJJJJJJJJJGGGGGGGGGGGG
JGJJJJJJJJJMMMMMJJJJJJJJJJJJJJJJJJJJJJGGGGGGGGGGGG
JJJJJJJJJJJJMMMJJJJJJJJJJJJJJJJJJJJJJJJGGGGGGGGGGG
GJJJJJJJJJJJMMMMJJJJJMMMMJJJJJJJJJJJJJJGGGGGGGGGGG
GJJJJJJJJJJJJMMMMMMJMMJMMJJJJJJJJJJGGGGGGGGGGGGGGG
JJJJJJJJJJJJJMMMMMMJJMMMJMMJJJJJJJJJGGGGGGGGGGGGGG
GJJJJJJJJJMMMMMMMMMMMMMJJJJJJJJJJJJJGGJGGGGGGGGGGG
JJJJJJJJJJMMMMMMMPPMMMMJJJJJJJJJJJJGGGGGGGGGGGJJGG
JJJJJJJJJJJMPPPMMMJMMMMJJJJJJJJJJJJJJGGGGJGGJGJJJG
JJJJJJJMMMMPPPMMMMJJMJMJJJJJJJJJJJJJJGGGGGGGGJJJJJ
JJJJJJJJMMPPPPPMMMMMJJJJJJJJJJJJJJJJJGGGGGGGGJJJJJ
JMMMMMMMJMMPPPPJMJJMJJJJMJJJJJJJJJGJJJGGGGGGJJJJJJ
MMMJMMJJJJPPPPMMMJJJJJJJMMMJJJJJJGGGGGGGGGGGJJJJJJ
PPMMMMMJJMMPPPPMPMMMMJJJMMMMMJJJGGGGGGGGGGGGJJJJJJ
MMMMPMPJMMPPPPPPPMMMMMJMMMMMMJJJGGGGGGGGGGGGJJJJJJ
PPMJMMPMJMMPPPPPPMMMPMJMPMMJJJJJGGGGGGGGGGGGJJJJJJ
MMMJMMMMJMJMPPPPPPMMMMMPPPMJMMJJGGGGGGGGGGGGJJJJJJ
PPMPMPMMJPMMPPPPPMPPPPMPPPMMMMJJJGGGGGGGGGGGJJJJJJ
MPMMPPPPMPPMMPPPPPMMPPPPMMMMMMJJJGGGJGGGGGGGGGJJJJ
PPMPPPPMMPPPMPPPPPPPPPMMMMJMMMJJJGJJGGGGGGGGGGGJJJ
PPMMPPPPMPPPPPPPPPPPMMMMMMJJMJJJJGGGGGGGGGGGGGGGGJ
PPPMPPPPPPPPPPPPPPPPMMJMMMJJJJJJJJJGGGGGGGGGGGGGGJ
PPPPPPPPPPPPPPPPPPPPPMMJJMJJJJJJJJJJGGGGGGGGGGGGGG
