GGGGGGGGGGGGGGGGGGGGGGGGGGDGDDDDDAAAAAAAAAAAAAAAAA
GGGDGGGGDDDGGGGGGGGGGGGGGGDDDDDAAAAAAAAAAAAAAAAAAA
GDDDDDGDDDGGGGGGGGGGGGGGGDGGDDDDAAAAAAAAAAAAAAAAAA
GDDDDDDDDDDGGGGGGGGGGGGGDDGGGDDDAAAAAAAAAAAAAAAAAA
GDDDDDDDDDDGGGDGGGGDDDDDDDGGGGGDAAAAAAAAAAAAAAAAAA
DDDDDDDDDDDGGGDDDDGDDAAAADGGGGGGAAAAAAAAAAAAAAAAAA
DDDDDDDDDDDDDDAAADDDAAAAAADDGGGGDAAAAAAAAAAAAAAAAA
GDDDDDDDDDDAAAAAAAAAAAAAAAADDDGDDAAAAAAADDDAADDDDD
GGDDDDDDDAAAAAAAAAAAAAAAAAAAADDDDAAAAADDDGDDDGGGDG
DDDDDDDDDDDDAAAAAAAAAAAAAAAAAADDDAAAADDGGGGDDGGGGG
DDDGDDDDGGDDAAAAAAAAAAAAAAAAAAAADAAADDDGGGGGGGGGGG
GGGGGGGGGGGDAAAAAAAAAAAAAAAAAAAAAADADDGGGGGGGGGGGG
GGGGGGGGGGDDAAAAAAAAAAAAAAAAAAAAAADDGGGGGGGGGGGGGG
GGGGGGGGGGGDAAAAAAAAAAAAAADAAAAAADGGGGGGGGGGGGGGGG
GGGGGGGGGGGDAAAAAAAAAAAAAADDDDDDDDGGGGGGGGGGGGGGGG
GGGGGGGGGGGGGAAAAAAAAAAAAADDDDDDDGGGGGGGGGGGJGGGGG
GGGGGGGGGGGGGDAAAAAAAAAAAADDGDDDDDGGGGGGGGGGJGGGGJ
JJGGGGGGGGGGGGDAAAAAAAAAADDGDDDDDGGGGGGGGGGJJJJJJJ
JGGJGGGGGGGGGGGDDDAAAAAAADDDDDDDGGGGGGGGGGJJJJJJJJ
JJGGGGGGGGGGGGGDAAAAAAAAAAAADDGGGGGGGGGGJJJJJJJJJJ
GGGGGJGGGGGGGGGGDAAAAAAAAAAADDGGGGGGGGGJJJJJJJJJJJ
GJJJJJGGGGGGGGGGDAAAAAAAAAAAADDGGGGGGGJJJJJJJJJJJJ
JJJJGGGGGGGGGGGGGDAAAAAAAAAADDGGGGGGGJJJJJJJJJJJJJ
JJJJGGGGGGGGGGGGGGDAAAAAAAAAADGGGGGGJJJJJJJJJJJJJJ
JJJJJJGGJJGGGGGGGGDAAAAAAAAAADGGGGGGJJJJJJJJJJJJJJ
JJJJJJJJJJJJJJGGGGDAAAAAAAAAADGGGGGGJJJJJJJJJJJJJJ
JJJJJJJJJJJJJJJGGGDDDDDAAAAADGGGGGGGGJJJJJJJJJJJJJ
JJJJJJJJJJJJJJJGGGGGGDDAAAAAADGGGGGGGJJJJJJJJJJJJJ
JJJJJJMJJJJJJJJJGGGGGGDAAAAAADDGGGGGGGJJJJJJJJJJJJ
JJJJJJMJJJJJJJJJJGGGGGGDDGDDDDDGGGGGGGGJJJJJJJJJJJ
JJJMJMMMMJJJJJJJJJGGGGGGGGDDDDGGGGGGGGGGJJJJJJJJJJ
JJMMMMMMMMJJMJJJJJGGGGGGGGGGGGGGGGGGGGGGJJJJJJJJJJ
MJMMMJMMMMMMMJJJJGGGGGGGGGGGGGGGGGGGGGGGGGGGJJJJJJ
JMMMMMMMMMMMMMJJJJGGGGGGGGGGGGGGGGGGGGGGGGGGGGJJJJ
MMMMMMMMPMMMMMMJJJGGGGGGGGGGGGGGGGGGDGGGGGGGGGGJJJ
MMMMPMMMMMMMMMMJJJJGGGGGGGGDDDDDDDDDDGGGGGGGGGGGGJ
MMMMPMMPMMMMMMMJJJJJGGGGGGGGGDDDGGGGDGDGGGGGGGGGGG
MPPPPPMPPMMMMMMJJJJJJGGGGGGGGGDDGGDDDDADDDGGGGGGGG
PPPPPPPPPPMMJMJMMJJJJGGJJGGGGGGDDDDAAAAADDDDDDDDGG
PPPPPPPPPMMMMMMMMJJJJJJJJGGGGGGGDDAADAAAAAAAAAAADG
PPPPPPPPPPPPMMMMMJJJJJJJJJJGGGGGGDAAAAAAAAAAAAAAAA
PPPPPPPPPPPPPPMMMMJJJJJJJJJJGGGGGGAAAAAAAAAAAAAAAA
PPPPPPPPPPPPPPMMMMJJJJJJJJJJGGGGGGDDDAAAAAAAAAAAAA
PPPPPPPPPPPPPPMMMMMMJJMJJJJJJGGGGGGGGDAAAAAAAAAAAA
PPPPPPPPPPPPPPMMMMJJMJMMJJJJJJJGGGGGGDDDDAAAAAAAAA
PPMPPPPPPPPMMMMMMMMJJMMMMMJJJJJGGGGGGGGGGDAAAAAAAA
PMMMPPPPPPPPMMMPMMMJJMMMMMJJJJJGGGGGGGGGGGGAAAAAAA
MMMMPMMMMMMMJMMMMMMMMMMMMMJJJJJGGGGGGGGGGGGAAAAAAA
MJMMMJMJMJMJMMJMJJJMMMMMMMMJJJJJJJGGGGGGGGGDAAAAAA
JJMMMPJJJJMMJMMJMMMJMMMMMMJJJJJJJJGJGGGGGGGGDAAAAA
