GGGGGGGGGGGGGGGGGGGGGGGGGGGGGGGGGDDDDDAAAAAAAAAAAA
GGGGGGGGGGGGGGJJJJGGGGGGGGGGGGGGGDDAAAAAAAAAAAAAAA
GGGGGGGGGGGGGJJJJJJGGGGGGGGGGDDDGDDAAAAAADDAAAAAAA
GGGGGGGGGGGGJJJJJJJJJGGGGGGGGDDDDDDAAAAAAADAAAAAAA
GGGGGGGGGGGGJJJJJJJJJGGGGDDGDDADDDAAAAAAAAAAAAAAAA
JJGGGGGGGGGJJJJJJJGGGGGGGDDDDAADDDAAAAAAAAAAAAAAAA
JJGGGGGGGGJGJJJJJGGGGGGGGDDDAAAAAAAAAAAAAAAAAAAAAA
JJJJGGGGGGJJJJJJJGGGGGGGGDAAAAAAAAAAAAAAAAAAAAAAAA
JJJJJGGGGGJJJJJJJGGGGGGGDDAAAAAAAAAAAAAAAAAAAAAAAA
JJJJJJGGGGJJJJJJJJJGGGGGDAAAAAAAAAAAAAAAAAAAAAAADD
JJJJJGGGGJJJJJJJJJJGGGGGDAAAAAAAAAAAAAAAAAAAAAADDG
JJJJJGJJJJJJJJJJJJJJGGGGDAAAAAAAAAAAAAAAAAAAAAAADG
MMMJJJJJJJJJJJJJJJJJGGGGGDDAAAAAAAAAAAAADAAAAAADDG
MMMJJJJJJJJJJJJJJJJGGGGGGGGDAAAAAAAAAAADDDAAAAADGG
MMMJJJJJJJJJJJJJJJJJGGGGGGGDDAAADAAAAADGGDAAADGDGG
MMMJJJJJJJJJJJJJJJJJGGGGGGGDDDAAAAADDDGGGDAAADDGGG
MMMJJJJJJJJJJJJJJJJJGGGGGGDDAAAAAAADGDGGGGGGDDGGGG
JJJJJJJJJJJJJJJJJJJGGGGGGDAAAAAAAAADGGGGGGGGGGGGGJ
MJJJJJJJJJJJJJJJJJJGGGGGGDAAAAAAAAADGGGGGGGGGGGGJJ
MMJJJJJJJJJJJJJJJJGGGGGDDAAAAAAAAAADGGGGGGGGGGJJJJ
MMJJJJJJJJJJJJJJJGGGGGDDAAAAAAAAAAADGGGGGGJGGJJJJJ
JJJJJJGJGGJJJGGGGGGGGDAAAAAAAAAAAAADGGGGGGGGJJJJJJ
JJJJJGGGGGGGJGGGGGGGDAAAAAAAAAAAAADGGGGGGJJJJJJJJJ
JJJJJGGGGGGGGGGGGGGDAAAAAAAAAAAAAAGGGGJJJJJJJJJJMJ
JJJJJGGGGGGGGGGGGGGDAAADAAAAAAAAAAGGGGJJJJJJJJJJJJ
JJJJJGGGGGGGGGGGGGGDAAADDAAAADDDADGGGGJJJJJJJJJJJJ
JJJJJGGGGGGGGGGGGGGDDDDGDDDDDGGDDDDGGJJJJJJJJJJJJJ
JJJJJJGGGGGGGGGGGGGGGGGGGGGGGGGGDDGGGJJJJJJJJJJJJJ
JJJJJGGGGGGGGGGGGGGGGGGGGGGGGGGGDGGGJJJJJJJJJJJJJJ
JJJJGGGGGGGGGGGGGGGGGGGGGGGGGGGGGGGGJJJJJJJJJJJJJJ
JJJGGGGGGGGGGGGGGGGGGGGGGGGGGGGGGGGJJJJJJJMMJJJMMJ
GGGGGGGGGGGGGGGGGGGGGGGGGGGGGGGGGGJJJMMJJJMJJJJMMM
GGGGGGGGGGGGGGGGGGGGGGGGGGGGGGGGJJJJMMMMMMJJMMMMPM
GGGGGGGGGGGGGGGGGGGGGGGGGGGGGGGJJJJMMMMMMMJJMMPMPP
GGGGGGGGGGGGGGGGGGGGGGGGGGGGGGJJJJJMMMMMPMMMMMPPPP
GGGGGGGGGGGGGGGGGGGGGGGGGGGGJJJJJJMMMPPPPMJMMPPPPP
GGGGGGGGGGGGGGGGGGGGGGGGGGGGJJJJMMMMMPPPPMPPPPPPPP
DGGGDDDDDGGGGGGGGGGGGGGGGGGJJJJJJJJMMPPPPPPMPPPPPP
DDDAADDGDDGGGGGGGGGGGGGGGGGGJJJJJJMMMMMPPPMPMPPPPP
GDAAAADDGGGGGGGGGGGGGGGGGGGGGJJJJJJMMMPPPMPMMPPPPP
GAAAADADGGGGGGGGGGGGGGGGGGGGGJJJJJMMMMPPPPPPPPPPPP
DAADDDDDGGGGGGGGGGGGGGGGJGJJJJJJJJJMJMPPPPPPPPPPPP
DAADDDDGGGGGGGGGGJJGGGGJJJJJJJJJJMMMMMMPMPPPPPPPPP
AAADDDGGGGGGGJJJJJJJGJJJJJJJJJJJJJMMMMPPPPPPPPPPPP
AADDGGGGGGGGJJJJJJJJJJJJJJJJJJJJJJMMPPMMPPPPPPPPPP
AAADGGDGGGGGJJJJJJJJJJJJJJJJJJJJJJJMMMPMPPPPMPPPPP
AAAADDDGGGGGJJJJJJJJJJJJJJJJJJJJJJJMMMMMMPPPPMPPPP
AAAAADDGGGGGJJJJJJJJJJJJJJJJJJJJJJJJMMMMMPPPPMMPPP
AAAAAADGGGGGJJJJJJJJJJJJJJJJJJJJJJJMMJMMMMMPPMMPPP
AAAAAADGGGGGJJJJJJJJJJJJJJJJJJJJGJJJJJMPMMPMPPPPPP
