JJMMMMMMJJMMMMMMMMJJJJJJJJJJJGJJJJGGGGJJJJJJJJJJJJ
JJMMMMMMMJMJMMMMMJJJJJJJJJJJJJJJJJGGGJJJJJJJJJJJJJ
JJJMMMMMMMJMMMMMJJJJJJJJJJJJJJJJJJJGGJJJJJJJJJJJJJ
JJJMMMMMJJJMMMMMJJJJJJJJJJJJJJJJJJJGGGJJJJJJJJJJJJ
JJJMMJJJJMMMMMMMJJJJJJJJJJJJJJJJJJJGGGGJGJJJJJJJJJ
JJJJMMMMJJMMMMJJJJJJJJJJJJJJJJJJJJGGGGGGGJJJJJJJJJ
MJJJJMJJJJMMMMJJJJJJJJJJJJJGGGJGGJGGGGGGGJJJJJJJJJ
JMJJMMMJJJJJJJJJJJJJJJJJJJGGGGGGGGGGGGGGGJJJJJJJJJ
JMMMMJMJJJJJJJJJJJJJJJJJGJGGGGGGGGGGGGGGGGGGGGGGGG
MJMMJMMJJJJJJJJJJJJJJJJJJGGGGGGGGGGGGGGGGGGGGGGGGG
MMMJJJJJJJJJJJJJJJJJJJJGGGGGGGGGGGGGGGGGGGGGGGGGGG
MMMMJJJJJJJJJJJJJJJJJGJGGGGGGGGGGGGGGGGDDDDGGGGGGG
MMMMMMMJJJJJJJJJJJJJJGGGGGGGGDGGGGGGGGDAAAAADGGGGG
MMMMMJJJJJJJJJJJJJJJJJJGGGGGDDDGDDGGDDAAAAAAAAADAD
JMMMJJJJJJJJJJJJJJJJJJGGGGDDDDDDDDDDDAAAAAAAAAAAAA
JMMJMJJJJJJJJJJJJJJJJGGGGGGDDDDDDDAAAAAAAAAAAAAAAA
JMMJJJJJJJJJJJJJJJJJJGGGGGDDDDDDDAAAAAAAAAAAAAAAAA
JMJJJJJJJJJJJJJJJJJJGGGGGGGGDDDDAAAAAAAAAAAAAAAAAA
JJJJJJJJJJJJJJJJJJGGGGGGGGGGGDAAAAAAAAAAAAAAAAAAAA
JJJJJJJJJJJJJJJJJJJGGGGGGGGGDDAAAAAAAAAAAAAAAAAAAA
JJJJJJJJJJJJJJJJJGGGGGGGDDDDAAAAAAAAAAAAAAAAAAAAAA
JJJJJJJJJJJJJJJGGGGGGGDDAAAAAAAAAAAAAAAAAAAAAAAAAA
JJJJJJJJJJJJJJJGGGGGGGDDAAAAAAAAAAAAAAAAAAAAAAAAAA
JJJJJJJJJJJJJJJGGGGGGGAAAAAAAAAAAAAAAAAAAAAAAAAAAA
JJJJJJJJJJJJJJJGGGGGGGDAAAAAAAAAAAAAAAAAAAAAAAAAAA
JJJJJJJJJJJJJJJJGGGGGGAAAAAAAAAAAAAAAAAAAAAAAAAAAA
JJJJJJJJJJJJJJJGGGGGGGDAAAAAAAAAAAAAAAAAAAAAAAAAAA
JJJJJJJJJJJJJJGGGGGGGGGAAAAAAAAAAAAAAAAAAAAAAAAAAA
JJJJJJJJJJJJJGGGGGGGGGDAAAAAAAAAAAAAAAAAAAAAAAAAAA
JJJJJJJJJJJJGGJGGGGGGGDAAAAAAAAAAAAAAAAAAAAAAAAAAA
JJJJJJJJJJJJJGGGGGGGGDDAAAAAAAAAAAAAAAAAAAAAAAAAAA
JJJJJJJJJJJJJJGGGGGGGGDDAAAAAAAAAAAAAAAAAAAAAAAAAA
JJJJJJJJJJJJJGGGGGGGGGGDAAAAAAAAAAAAAAAAAAAAAAAAAA
JJJJJJJJJJJJJJGGGGGGGGGDAAAAAAAAAAAAAAAAAAAAAAAAAA
JJJJJJJJJJJJJJGJGGGGGGGDAAAAAAAAAAAAAAAAAAAAAAAAAA
JJJJJJJJJJJJJJGGGGGGGGGGAAAAAAAAAAAAAAAAAAAAAAAAAA
JJJJJJJJJJJJJGGGGGGGGGGDAAAAAAAAAAAAAAAAAAAAAAAAAA
JJJJJJJJJJJJJGGGGGGGGGGDDAAAAAAAAAAAAAAAAAAAAAAAAA
JJJJJJJJJJJJJGGGGGGGGGGGDAAAAAAAAAAAAAAAAAAAAAAAAA
JJJJJJJJJJJGGGGGGGGGGGGGDAAAAAAAAAAAAAAAAAAAAAAAAA
JJJJJJJJJJJGJGGGGGGGGGGGGDAAAAAAAAAAAAAAAAAAAAAAAA
JJJJJJJJJJJJGGGGGGGGGGGGDAAAAAAAAAAAAADAAAAAAAAAAA
JMJMJJJJJJJJGGGGGGGGGGGGDAAAAAAAAAAAADDDAAAAAAAAAA
MMMMJJJJJJJJJJJJGGJGGGGGDAAAAAAAAAAAADDDDDDDDDDDAA
MJMMJJMJJJJJJJJJJGGGGGGGDAAAAAAAAAAAAADDDGGGGDGGDD
MMMMJMMJJJJJJJJJJJJJGGGGDAAAAAAAAAAAAAADGGGGGGGGDD
MMMMMMJJJJJJJJJJJGGGGGGGDDAAAAAAAAAAAAADDGGGGGGGGG
MMMMMMMMJJJJJJJJJGGGGGGGGGDDAAAAAAAAAAADDDGGGGGGGG
MMMMMJJMJJJJJJJJJJJGGGGGGGGDDDAAAAAAADDDDDGGGGGGGG
MMMMJJJJJJJJJJJJJJJJGGGGGGGGDDDDAAAAADDGGGGGGGGGGG
