AAAAAADGGGGGGGGGJJJJJJJJJJMMJMMMMMMPPPMMPMPPMMMMJM
AAAAAADGGGGGGGGGGJJJJJJJJJMMJJJMMMMPPPPMPPPPPPMPJM
AAAAAAAGGGGGGGGGGJJJJJJMJMMJMMMMMPPMPPPMMPPPPPPPPM
AAAAAAAGGGDGDGGGGJJJJJJJMJJJJMMJMMMMMMPPPPPPPPPMMM
AAAAAAADGGDDDDGGGJJJJJMMMMMJMMMMMMMMJMPMPPPPPPPPPM
AAAAAAADDGDDDDGGGJJJJJMMMMMMMMMMJJJJMMMPPPPPPPPPPP
AAAAAAAAAADDDDGGGJJJJMMMMMMMMMJJJJJJJMMMPPPPPPPPPP
AAAAAAAAAAAAADGGGGJJJMMMMMJMJJJMJJJJJMMPPPPPPPPMPJ
AAAAAAAAAAADDDGGGGJJJJMJJMJJJJJMJJJJJMMPPMMJMJPMMJ
AAAAAAAAADDDDDDGGGJJJJJJJJJJJJJMMJJJMMJMJJPPMJJJPM
AAAAAAAAAADDDDGGGGGJJJJJJMMMMMJJJJJJMMJMJMPPPPPMMM
AAAAAAAAAAADDDDGGGGGGJJJJMJMMMMMMMJJJMMJMJPMPPPPMP
AAAAAAAAAAAADDDGGGGGGJJJJJMMMMMMMMMJMMJJMMPMMPPPPP
AAAAAAAAAAAAAAADGGGGGJJJJJJJMMMMMMMJMMMJMMPPPPPPPP
AAAAAAAAAAAAAAAAGGGGGJJJJJJJMMMMMJJJJJJJJMPPPPPPPP
AAAAAAAAAAAAAAAADGGGJJJJJJJJMMMMMMMMJJMMPMMPPPPPPP
AAAAAAAAAAAAAAAADGGGGJJJJJJJMMMMMMMJJJMMMPMPPPPPMM
AAAAAAAAAAAAAAAADGGGGGJJJJJJMMMMMMMMJMMMMMMPPMMMMM
AAAAAAAAAAAAAAAADGGGGGJJJJJJJMMMMPMMMMMJMPMPPMMMMJ
AAAAAAAAAAAAAAAAADGGGGJJJJJJMMMMMMMMMMJMMMMMPPMJMJ
AAAAAAAAAAAAAAAAAADGGGGJJJJJMMMJMMMMMMMMMPMMPPMMJM
AAAAAAAAAAAAAAAAAADGGGJJJJJJJJJMMMMMMMMMMMMPMMMJJJ
AAAAAAAAAAAAAAAADDDGGGGJJJJJJJJJMMMMMMMMMJMMMMMMJJ
AAAAAAAAAAAAAAADDDDGGGGGGJJJJJJJMMMMMMJMMMJMMMMMMM
AAAAAAAAAAAAAAADDDDDGGGGGJJJJJJJJMMMMMJMMJMMMMMMMM
AAAAAAAAAAAAADDGGGDDGGGGGGGJJJJJJMMMMMMJJJJMMJJMJM
AAAAAAAAAAAADDDGGGGGGGGGGGGJJJJJJJJJJJJJJJJJJJJJJM
AAAAAAAAAAAAADDGGGGGGGGGGGGGJJJJJJJJJJJJJJJJJJJJJM
AAAAAAAAAAAAADDDGGGGGGGGGGGGJJJJJJJJJJJJJJJJJJJJJJ
AAAAAAAAAAAAAADDGGGGGGGGGGGGGGJJJJJJJJJJJJJJJJJJJJ
AAAAAAAAAAAAAADDGGGGGGGGGGGGGGJJJJGGGJJJJJJJJJJJJJ
AAAAAAAAAAAAAADDGGGGGGGGGGGGGGGGGGGGGGGJJJJJJJJJJJ
AAAAAAAAAAAAAADGGGGGGGGGGGGGGGGGGGGGGGGJJJJJJJJJJM
AAAAAAAAAAAAADDDGGGGGGGGGGGGGGGGGGGGGGGJJJJJJJJJMJ
AAAAAAAAAAAAADGGGGGGGGGGGGGGGGGGGGGGGGGJJJJJJJJJMJ
AAAAAAAAAAAAADGGGGGGGGGGGGGGGGGGGGGGGGGGJJJJJJJJJJ
AAAAAAAAAAAAAGGGGGGGGGGGGGGGGGGGGGGGGGGJJJJJJJJJJJ
AAAAAAAAAAAAAGGGGGGGGGGGGDDDDDGGGGGGGGGGJJJJJJJJJJ
AAAAAAAAAAAADGGGGGGGGGGGGGDDDDGGGGGGGGGJJJJJJJJJJJ
AAAAAAAAAAAADGGGGGGGGGGGGDDDDGGGGGGGGGJJJJJJJJJJJJ
AAAAAAAAAAAADGGGGGGGGGGDDDDDDGGGGGGGJJJJJJJJJJJJJJ
AAAAAAAAAAADDGGGGGGGGGDDAADDGGGGGGGGJJJJJJJJJJJJJJ
AAAAAAAAAAADGGGGGGGGDDDDAAADGGGGGJJJJJJJJJJJJJJJJJ
AAAAAAAAADDGGGGGGGDDAAAAAAADGGGGJJJJJJJJJJJJJJJJJJ
DAAAAAAADDGGGGGGGGDDAAAAAAAAGGGGJJJJJJJJJJJJJJJJJJ
DAAAAAAADGGGGGGGGGDDAAAAAAAADGGJJJJJJJJJJJJJJJJJJJ
DAAAAAAADGGGGGGGGGGDAAAAAAAADGGJJJJJJJJJJJJJJJJJJJ
DAAAAAAADGGGGGGGGGGAAAAADAAADGGJJJJJJJJJJJJJJJJJJJ
DAAAAADDADGGGGGGGGGDDAADDAAAGGGJJJJJJJJJJJJJJJJJJJ
DAADDDDDAAGGGGGGGGGDDDDDDAADGGGJJJJJJJJJJJJMJJJJJJ
