AAAAAAAAAAAAAAAAAAAAAAAAAAAAAAAAAAAAAAAAAAAADAADGG
AAAAAAAAAAAAAAAAAAAAAAAAAAAAAAAAAAAAAAAAAAAADAADGG
AAAAAAAAAAAAAAAAAAAAAAAAAAAAAAAAAAAAAAAAAAAADDDDGG
AAAAAAAAAAAAAAAAAAAAAAAAAAAAAAAAAAAAAAAAAAAADDGGGG
AAAAAAAAAAAAAAAAAAAAAAAAAAAAAAAAAAAAAAAAAAAADGGGGG
AAAAAAAAAAAAAAAAAAAAAAAAAAAAAAAAAAAAAAAAAAAADGGGGG
AAAAAAAAAAAAAAAAAAAAAAAAAAAAAAAAAAAAAAAAAAADDGGGGG
AAAAAAAAAAAAAAAAAAAAAAAAAAAAAAAAAAAAAAAAAAADDGGGGG
AAAAAAAAAAAAAAAAAAAAAAAAAAAAAAAAAAAAAAAAAAADDGGGGG
AAAAAAAAAAAAAAAAAAAAAAAAAAAAAAAAAAAAAAAAAADADGGGGG
AAAAAAAAAAAAAAAAAAAAAAAAAAAAAAAAAAAAAAAAADDDGGGGGG
AAAAAAAAAAAAAAAAAAAAAAAAAAAAAAAAAAAAAAAAADDGGGGGGG
DAAAAAAAAAAAAAAAAAAADDDAAAAAADDAAAAAAAAAAAGGGGGGGJ
DAAAAAAAAAAAAAAAAAADDDDDADDDADDAAAAAADDAADGGGGGGGJ
GDAAAAAAAAAAAAADAAADDGGGDDDDDDDAAAAAADDDGGGJJJJGJJ
GDAAAAAAAAAAAADDAADDGGGGDDGGGGGGDDGDDGGGGGGGGJJJJJ
GDAAAAAAAAAAAAAAADDDGGGGGGGGGGGGGDGGGGGGGJGGJJJJJJ
GDDDAAAAAAAAAAAADDDDGGGGGGGGGGGGGGGGGGGGJJJGJJJJJJ
DDDDAAAAAAAAAAAAAADGGGGGGGGGGGGGGGGGGGJJJJJJJJJJJJ
DDDDAAAAAAAAAAAAAADGGGGGGGGGJJGGGGGGGJJJJJJJJJJJJJ
DDDDAAAAAAAAAAAAAADGGGGGGGGJJJJGGGGGJJJJJJJJJJMJJJ
DDDDAAAAAAAAAAAAAADGGGGGGGJJJJJJJGJJJJJJJJJJMMMMJJ
DDADAAAAAAAAAAAAAAAGGGGGGJJJJJJJJJJJJJJJJJJMMMMMJJ
GDAAAAAAAAAAAAAAAAADGGGJJJJJJJJJJJJJJJJJJJJJMMJMJJ
GDAAAAAAAAAAAAAAAAADGGGJJJJJJJJJJJJJJJJJJJJJMMJJJJ
GDAAAAAAAAAAAAAAAAADGGGGJJJJJJJJJJJJJJJJJJJJMJJJJJ
GDAAAAAAAAAAAAAAAAAGGGGJJJJJJJJJJJMMMMMJJJJJJJJJJJ
DDAAAAAAAAAAAAAAAAAAGGGGJJJJJJJJJJMMMMMMJJJJJJJJJG
GDAAAAAAAAAAAAAAAAAADGGGJJJJJJJJMMJMMMJMJJJJJJJJGG
GGGGDAAAAAAAADDGGDDDGGGGJJJJJJMMMJJMMMJMMJJJJJJJJG
GGGGGGAADAAAADDGGGGGGGGJJJJJJMMMMJJMMMJJJJJJJJJJJG
GGGGGGDDDAADDGGGGGGGGJJJJJJJJMMMMMJMMMJJJJMJJJJJGJ
GGGGGGGDDDDGGGGGGGGGJJJJJJJJJMMMMMMMMMMMJJMMJJJJJJ
GGGGGGGGGGGGGGJJJJJJJJJJJMMJMMMMMMMMMMMMMMMMJJJJJJ
GGGGGGGGGGGGGJJJJJJJJJJJMMMMMMPPMMMMPMMMMMMMJJGJJJ
GGGGGGGGGGGGGJJJJJJJJJJJMMMMMMMMPMMMMMMMMMMMMJJGJJ
GGGGGGGGGGJJJJJJJJJJJJJMMMMMMMMPMMMMMMMMMMMMMJJJJJ
JGGGGGGGGGGJJJJJJJJJJJMMMMMMPMMMPMMMMMMMMMMMMMJJJJ
JGGGGGGGGGJJJJJJJJJJJJJMMMMMMMMMMPMMMMMMMPPMMMJJJJ
GGGGGGGGGGGJJJJJJJJJJJJMMMMMMMMMPPPMMMMMPPPPMMJJJJ
GGGGGGGGGGGJJJJJJJJJJJJJMMMMMMMMPPPMMMMMMMMMMMMJJJ
GGGGGGGGGGGGJJJJJJJJJJJJMMMMMMMMPPPMMJMMPMMJJMMJJJ
GGGGGGGGGGGGJJJJJJJJJJJMMMMMMMMMPMMMMMMMMMMJMMMJJJ
DDGGGGGGGGGJJJJJJJJJJJJMMMMMMMMMMMMMJMJMMMJJJJMJJJ
DDDGGGGGGGGGJGJJJJJJJJJJMMMMJMMMMMMJJJJJMJJJJJJJJJ
DDDDGGGGGGGGGGGGGJJJJJJJMMJJMMMMMMMMMJJJJJJJJJJJJJ
DDDDDGGGGGGGGGGGGGJJJJJJJMJMJMMMMMJMJJJJJJJJJJJJJJ
DDDDDDDDDGGGGGGGGGJJJJJJJMJMMMMMJMJJJJJJJJJJJJJJJJ
DDDDDDDDDGGGGGGGGJJJJJJJMMMMMMMJMMJJJJJJJJJJJJJGGG
DDDDDDDDDDDGGGGGGGGJJJJJJMMMMMMMJJJJJJJJJJJJJJGGGG
