GGGGGGGDAAAAAAAAAAAAAAAAAAAAAAAAAAAAAAAAAAAAAAAAAA
GGGGGGGGDAAAAADAAAAAAAAAAAAAAAAAAAAAAAAAAAAAAAAAAA
JGJGGGGDDAAAAAAADDAAAAAAAAAAAAAAAAAAAAAAAAAAAAAAAA
GGGGGGDDAAAADDDDDDAAAAAAAAAAAAAAAAAAAAAAAAAAAAAAAA
GGGGGGDDAAAADDGGGDAAAAAAAAAAAAAAAAAAAAAAAAAAAAAAAA
GJGGGGDDAADGGGGGDDDAAAAAAAAAAAAAAAAAAAAAAAAAAAAAAA
GGGGGGDAAADGGGGGGGGDAAAAAAAAAAAAAAAAAAAAAAAAAAAAAA
GGGGGGGDDGGGGGGGGGGGDDDDDDDAAAAAAAAAAAAAAAAAAAAAAA
GJJJGGGGGGGGGGGGGGGGGGGGGDDDDDAAAAAAAAAAAAAAAAAAAA
GJJJJGGGGGGGGGGGGGGGGGGGGGDDDDDAAAAAAAAAAAAAAAAAAA
JJJJJGGGGGGGGGGGGGGGGGGGGGGGGDDAAAAAAAAAAAAAAAAAAA
JJJJJJJJGGGGGGGGGGGGGGGGGGGGGDDAAAAAAAAAAAAAAAAAAA
JJJJJJJJGGGGGGGGGGGGGGGGGGGGGDDAAAAAAAAAAAAAAAAAAA
JJJJJJJJJGGGGGGGGGGGGGGGGGGGDDAAAAAAAAAAAAAAAAAAAA
JJJJJJJJJGGGGGGGGGGGGGGGGGGGDAAAAAAAAAAAAAAAAAAAAA
JJJJJJJJJJGGGGGGGGGGGGGGGGGGAAAAAAAAAAAAAAAAAAAAAA
JJJJJJJJJJGGGGGGJGGGGGGGGGGGAAAAAAAAAAAAAAAAAAAAAA
JJJJJJJJJJJJJJJJGGGGGGGGGGGGAAAAAAAAAAAAAAAAAAAAAA
JJJJJJJJJJJJJJJJJGGGGGGGGGGGDAAAAAAAAAAAAAAAAAAAAA
JJJJJJJJJJJJJJJJJJJJJGGGGGGDDAAAAAAAAAAAAAAAAAAAAA
JJJJJJJJJJJJJJJJJJJJJGGGGGGGDAAAAAAAAAAAAAAAAAAAAA
JJJJJJJJJJJJJJJJJJJJGGGGGGGGGAAAAAAAAAAAAAAAAAAAAA
JMMMMJJJJJJJJJJJJJJGGGGGGDDGGAAAAAAAAAAAAAAAAAAAAA
MMMMJJJJJJJJJJJJJJJGGGGGDDDDDAAAAAAAAAAAAAAAAAAAAA
JMMMJJJJJJJJJJJJJJJGGGGDAADDDDAAAAAAAAAAAAAAAAAAAA
MMMJJJJJJMJJJJJJJJJJJGGGAAAAAAAAAAAAAAAAAAAAAAAAAA
MJJJJJJJMJMJJMJMJJJJJJGGDAAAAAAAAAAAAAAAAADAAAAAAA
JMJJJJJMMJMJMMMMJJJJJJGGGGDAAAAAAAAAAAAAAAAAAAAAAA
JJJJJJJMMMMMJMMMJJJJJJGGGGDDDAAAAAAAAAAAAADAAAAAAA
MJJJJJJMMMMMMMMMJJJJGGGGGGGGDAAAAAAAAAAAAAAAAAAAAA
JJJJJJJJJMMMMMMMJJJJJGJGGGGGDAAAAAAAAAAAAAAAAAAAAA
MMJJJJMMMMMMMMMMMJJJJGGGGGGGDAAAAAAAAAAAAAAAAADADD
JMMMMJMMJMPMMMMMMJJJJGGGGGGGDAAAAAAAAAAAAAAAADDGGG
JJJJMMMMMMPPMMMJJJJJJGGGGGGGAAAAAAAAAAAAAAAADGGGGG
MMMMPPMMMMPMPMMJJJJJGGGGGGGDAAAAAADGDDDAAAADGGGGGG
MJJJMPPPMMMMPMMMMJJJJGGGGDDAAAAAADGGGGDAADDDGGGGGG
MMMJJMPPPPMPPMMMJJJJJGGGDDDAAAAAAGGGGGGDDDDGGGGGGG
MMMJMPPPPPPPMMMMMJJJJJGGGGAAAAAADDGGGGGGGGDGGGGGGG
JJMMPPMMPPPPMMMMMJJJJJJGGGDAAAADGGGGGGGGGGGGGGGGGG
MMJPMMJMMPMMMMJJJJJJJJJGGGGGADDGGGGGGGGGGGGGGGGGGG
MJJMMMMMMMMJMMMMJJJJJJJJGGGGDDGGGGGJGGGGGGGGGGGGGG
MJMJMJMMMMMMMJJMMJJJJJJJJGGGGGGGGJJJJGGGGGGGGGGGGG
MJMMJJMMMMMJMMMMMJJJJJJJJJJJGGGGGJJJJGGGGGGGGGGGGG
MMMMMMMJMMPMMMMMJJJJJJJJJJJJJGGGGJJJJGGGGGGGGGGGGG
PMJJJMMMPPPPMMMMJJJJJJJMJJJJJGGJJJJJGGGGGGGGGGGGGG
PMMMJMMPMPPPMMMMMJJJJMMMJJJJJGGJJJJJJGGGGGGGGGGGGG
PMPPMMMMPPPPPPMJMMJMMMMJJJJJJJJJJJJJJJGGGGGGGGGGGG
PPPPMMMPPPPPMPMMMMMMMJJJJJJJJJJJJJJJJJJJGGGGGGGGGG
PPPPPMMPPPPPMPMMMMMMMMJJJJJJJJJJJJJJJJJJJGGGGGGGGG
PPPPPPMPPPPPMMPMMPMMJJJJJJJJJJJJJJJJJJJJJGGGGGGGGG
