PPPJJMPPMJMMMMJJMMJMMJJJJJJJJMJJJJJJJJJGJGGGGGGGGG
PMMPMPMMPMMJJMMPMMMMMMMMJJJJJJJJJJJJJJGGGGGGGGGGGG
MPPPPPPPJJMMMPPPMMPPMMMMJJJJJJJJJJJJJGGGGGGGGGGGGG
PPPPPPPPMMMMMMPPPJPPPPMJJJJJJJJJJJJJJJGGGGGGGGGGGG
MPPPPPPMJMMPPPPPPPPPPMJMMJMJMJJJJJJJJJGGGGGGGGGGGG
PPPPPMPMJPMPPPPPPPPPPMMMMMJMMJJJJJJJJJJGGGGGGGGGGG
PPPPPPPPPMPPPPPPPPPPPPPMMMMMMMJJJJJJJJJJJGGGGGGGGG
PPPPPPPPPMMPPPPPPPPPPPMMMPMMJMJJMJJJJJJJJGGGGGGGGG
PPPPPPPPPPPPPPPMPPPPPPPPPPPMMMJJMMJJJJJJJJGGGGGGGG
PPPPPPPPPPPMPPPMPMPPPPPPPPMMMJMMMJJJJJJJJJGGGGGGGG
PPPPPPPPPPPPPPPMMPPPPPPPPPMMMJJJJJJJJJJJJJJGGGGGGG
PPPPPPPPPPMPPMMMMMMPPPPMMMMJJJJJJJJJJJJJJJJGGGGGGG
PPPPPPPPPPPPMMJMMJMPPPMMMMJJJJJJJJJJJJJJJGGGGGGGGG
PPPPPPPPPMPPPMMMPPMPMJMMJMJJJJJJJJJGGGGGGGGGGGGGGG
PPPPPPPPPPPMPPPPPMMMMMMMMJJJGGGJJGGGGGGGGGGGGGGGGG
PPPPPPPPPPPPPPPPPMMMJJJMJJJGGGGGGGGGGGGGGGGGGGGGGG
PPPPPPPPPPPPPMMPPMPMMMMMJJJGGGGGGGJGGGGGGGGGGGGGGG
PPPPPPPPPPPPMMPPMPMMMMMMMJJJGGGGGJGGGGGGGGGGGGGGGG
PPPPPPPPPPPPMPJJMMJMMMMMJJJJGGGGGGGGGGGGGGGGGGGGGG
PPPPPPPPPPPPPPMJMMJJMJMMJJJJGGGJGGGGGGGGGGGGGGGGGG
MPMPPPPPPPMMMPPPMMMJMJJMJJJJGGGJJGGGGGGGGGGGGGGGGG
MPMPPPMPPPPPMMJMMMMJJJJJMJJJJGGJJJGGGGGGGGGGGGGGGG
PJMPPPPMMPPPPMPMMMMMJJJJJJJJGGGGGGGGGGGGGGGGGGGGGG
PMMPMPPPPPPPPPPPPJMJJMJJJJJJGGGGGGGJGGGGGGGGGGGGGG
PPMMPPPPMPPPPPPPMJMMJJJJJJJJGGGGJJGGJGGGGGGGGGGGGG
PPPPMPPPPPPPPPPPPPMMMMMJJJJJGGGGGJGGGGGGGGGGGGGGGG
PPPMJPPPPPPPPMPMMMMMMJJJJJJJJGGGGGGGGGGGGGGGGGGGGG
PPPMPPPPPPPPPPMMMJMJJJJJJJJJJGGGGGGGGGGGGGGGGGGGGG
PPMMPPPPPPPPPPPMMMMJJJJJJJJJGGGGGGGGGGGGGGGGGGGGGG
MPMPMPPMPPPPPPPPMMJJJJJJJJJJJGGGGGGGGGGGGGGGGGGGGG
MMMMPPPPPPPPPPPPPMMJJJJJJJJJJGGJGGGGGGGGGGGGGGGGGG
MMPJPMMPPPPPPPPPPMMJJJJJJJJJJGGGGGGGGGGGGGGGGGGGGG
PJMMMPMPPPPPPMMMMMMJJJJJJJJJGGGGGGGGGGGGGGGGGGGGGG
PPMPMPPPPPPPPMMMMMMJJJJJJJJJGGGGGGGGGGGGGGGGGGGDDD
MPMMMJPPPPPPPMMJMMJJJJJJJJJJGGGGGGGGGGGGGGGGGDDDDD
MMMJMMPPPPPMMMMMMMJJJJJJJJJGGGGGGGGGGGGGGGGGGDDDDA
MMJJJMPPMPPMMJMMMJJJJJJJJJJGGGGGGGGGGGGGGGDDDDDAAA
JJJJJMMMMPMMMMJMMJJJJJJJJJJGGDGGGGGGGGGGGDAAAAAAAA
JJJJJJMMMMMMMMMJJJJJJJJJJJGGGDDDDDDDDGGGGDAAAAAAAA
JJJJJJMMJMMMMJJJJJJJJJJGGGGGGDAAAAAADGGDDDAAAAAAAA
JJJJJJJJJMJJJJJJJJJGGGJGGGGDAAAAAAAAADDDDAAAAAAAAA
JJJJJJJJJMJMMJJJJJGGGGGGGDAAAAAAAAAAAAAAAAAAAAAAAA
JJJJJJJJJJJMMJJJJGGGGGDGDAAAAAAAAAAAAAAAAAAAAAAAAA
JJJJJJJJJJJJJJJJJGGGDDDAAAAAAAAAAAAAAAAAAAAAAAAAAA
JJJGJJJJJJJJJJJJJGGGGDAAAAAAAAAAAAAAAAAAAAAAAAAAAA
GGGGGJJJJJJJJJJGGGGGGDDAAAAAAAAAAAAAAAAAAAAAAAAAAA
GGGGGJJJJJJJJJJGGGGGGDDAAAAAAAAAAAAAAAAAAAAAAAAAAA
GGGGGJJJJJJJJGGGGGGDDAAAAAAAAAAAAAAAAAAAAAAAAAAAAA
GGGGJJJJJJJJJJGGGGGDAAAAAAAAAAAAAAAAAAAAAAAAAAAAAA
GGGGGJJJJJJJJJGGGGDDAAAAAAAAAAAAAAAAAAAAAAAAAAAAAA
