AAAAAAAAAAAAAAAAAADDGGGGGJJJJJJJJJJJMMMMMMMPPMMPPM
AAAAAAAAAAAAAAAAAAADGGGGGJJJJJJJJJJJJMMMMPMMPMPPPM
AAAAAAAAAAAAAAAAAAADGDGGGJJJJJJJJJJMJJMMPMMMMMPPMM
AAAAAAAAAAAAAAAAAAAADDGGGJJJJJJJJJJMMMMMMMMMMMMMMM
AAAAAAAAAAAAAAAAAAAAAADGGJJJJJJJJJJMMMMMMMMJMMMMMJ
AAAAAAAAAAAAAAAAAAAAAAAGGGJJJJJJJJJJMMMMMMMMMMMMMM
AAAAAAAAAAAAAAAAAAAAAAAGGGGJJJJJJJJJMMMJMJMJMJJMJJ
AAAAAAAAAAAAAAAAAAAAAAAGGGGJJJJJJJJJJJJJJJJJJJJJJJ
AAAAAAAAAAAAAAAAAAAAAADGGGGGGJJJJJJJJJJJJJJJJMJJMM
AAAAAAAAAAAAAAAAAAAAAADGGGGGGGJJJJJJJJJJJJJJJMMMJJ
AAAAAAAAAAAAAAAAAAAAAADGGGGGGGJJJJJJJJJJJJJJJMMMMJ
AAAAAAAAAAAAAAAAAAAAAADGGGGGGGJJJJJJJJJJJJJMJMMMJJ
AAAAAAAAAAAAAAAAAAAAAAADGGGGGGGGGJJJJJJJJJJJMMJMJJ
AAAAAAAAAAAAAAAAAAAAAAADGGGGGGGGGJJJJJJJJJJMMJJJJJ
AAAAAAAAAAAAAAAAAAAAAADGGGGGGGGGGJJJJJJJJMJMMMMJJJ
AAAAAAAAAAAAAAAAAAAAAAGGGGGGJJGGJJJJJJJJJJJJMMMJJJ
AAAAAAAAAAAAAAAAAAAAADDGGGGGJJJGGGJJJJJJJJMJMJJJJJ
AAAAAAAAAAAAAAAAAAAAAGGGGGJGGGGGGGGGJJJJJJJJMMMMJJ
AAAAAAAAAAAAAAAAAAAAADGGGJJJGGGGGGGGGGGJJJMMMMMMMJ
AAAAAAAAAAAAAAAAAAAAADGGGJJJJGGGGGGGGGJJJMMMMMMMJJ
AAAAAAAAAAAAAAAAAAAAADGGGGGGGGJGGJGGGJGJJMMMMMMJJJ
AAAAAAAAAAAAAAAAAAAAADGGGGGGGGGJJJJJGJJJJJMMMMMJJJ
AAAAAAAAAAAAAAAAAAAAADGGGGGGGJJJJJJJJJJJJJJJMMMMJJ
AAAAAAAAAAAAAAAAAAAAAADGGGGGGJJJJJJJJJJJJJJMMMMMMJ
AAAAAAAAAAAAAAAAAAAAAAADGGGGGJJJJJJJJJJJJJJJJMMMMM
AAAAAAAAAAAAAAAAAAAAAADDGGGGGJJJJJJJJJJJJJJMJMMMMM
AAAAAAAAAAAAAADDDDDAAADGGGGGGJJJJJJJJJJJJJJJJJMJMM
AAAAAAAAAADDGGGGDDDDDDDDGGGGGJJJJJJJJJJJJJJJJJJJMM
AAAAAAADDGGGGGGGGGGGDGGGGGGJJJJJJJJJJJJJJJJJJJJJMM
AAAAAAADGGGGGGGGGGGGGGGGGGJJJJJJJJJJJJJJJJJJJJJMJM
AAAAAADGGGGGGGGGGGGGGGGGGGJJJJJJJJJJJJJJJJJJJJJJJJ
AAADDGGGGGGGGGGGGGGGGGGGGGJJJJJJJJJJJJJJJJJJJJJJJJ
DDDGGGGGGGGGGGGGGGGGGGGGGGJJJJJJJJJJJJJJJJJJJJJJJJ
DDGGGGGGGGGGGGJJGJGGGGGGGGGGJJJJJJJJJJJGJJJJJJJJJJ
GGGGGGGGGGGGGJJJGGJGGGGGGGGGJJJJJJJJJJJGJJJJJJJJJJ
GGGGGGGGGGJJJJJJGGGGJJGGGGGGJJJJJJJJJGJGJJJJJJJJJJ
GGGGGGGGGJJJJGGJGJJGJJJJJGGGGJJJJJJJJGGGGGJJJJJJJJ
GGGGGGGGGJJJJJGGGGGGJJJJJJGJJJJJJJJJGGGGGJJJJJJJJJ
GGGGGGGGGGJJJGGGGGGGJJJJJJJJJJJJJJJJJJJJJJJJJJJJJJ
GGGGGGGGGJJGGGGGGGGGGJJJJJJJJJJJJJJJJGGJJJJJJJJJJJ
GGGGGGGGGGGJGGGGGGGGGJJJJJJJJJJJJJJJJJJJJJJJJJJJJJ
GGGGGGGGGGGGGGGGGGGGGJJJJJJJJJJJJJJJJJJJJJJJJJJJJJ
GGGGGGGGGGGGGGGGGGGGGJGJJJJJJJJJJJJJJJJJJJJJJJJJJJ
DGGGGGGGGGGGGGJGGGGGGGGGGJJGJJJJJJJJJJJJJJJJJJJJJJ
DGGGGGGGGGGGGGGGGGGGGGJGGGGGGGGJJJJJJJJJJJJJJJJJJJ
DDGGGGGGGGGGGGGGGGGGGJJGGGGGGGGGGJJJJJJJJMJJJJJJJJ
DDDDGGGGGGGGGGGGGGGGJJJJGGGGGGGGGGJJJJJJJMMMJJJJJJ
DDDDDGGGGGGGGGGGGGGGGJJGGGGGGGJJJJJJJJJJMJMMMJJJJJ
DDDGGGGGGGGGGGGGGGGGGGGGGGGGGJJJJJJJJJJJJJMMMMMJJJ
DDDDGGGGJJJJJGGGGGGGGGGGGGGGGJJJJJJMMJJMJMMMMMMJJJ
