JJJJMMMJJJJJJJMMMMMJJJJJJJJJJJJJMMMMJJPPPPPMJJJMMP
JJJMJJMMJJJJJJJJJMJJJJJJJJJJJJJJJMMMJMPPPPPMMJJMMP
JJJMMJMJJJJJJJJJJMJJJJJJJJJJJGGJJMMMJJMMPPPPJMMMMP
JJJJJJJJJJJJJJJMJJJJJJMJJJJJJJJJJJJMMJMMMMMPMPMMMM
JJJJJJJJJJJJMMMMMJJJJMJJJJJJJJJJJJJJMJJMMPPPPPJJMJ
JJJJJJJJJJJJMMMMMJJJJJJJJJJJJJJJJJJJJJMPMPMPMPMMPJ
JJJJJJJJJJJJMMMMJJJJJJJJJJJJJJJJJJJJJJJMMMPPMMPPPJ
JJJJJJJJJJJJJMMJJJJJJJJJJJJJJJJJJJJJJJJJJJMMMJMJMP
GGJJJJJJJJJJJJJJJJJJJJJJJJJJJJJJJJJJJJJJJJJMMMMMPP
GGGGJJJJJJJJJJJJJJJJJGGGGJJJJJJJJJJJJJJJJMJJJJMMMP
GGGGJJJJJJJJJJJJJJJJJGGGJGJJJJJJJJJJJJJJJMJMMMJMMM
GGGGJJJJJJJJJJJJJJJJJJGGGJJJJJJJJJGGJJJJJMMMJMMMPM
GGGGJJJJJJJJJJJJJJJJJJGGGJJJJJJJJJGGGJJMMPPMPMMMMM
GGGGGJJJJJJJJJJJJJJJJJGGGGGJJJJJJJJGJJJMMMMMPPPMMM
GGGGGJJJJJJJJJJJJJJJJGGGGGGGJJJJJJGGJJJMMMPMMMMPMP
GGGGGJJJJJJJJJJJJJJJJGGGGGGGGGJGGGGGGJJMMMMMMMPPPP
GGGGGGGJJJJJJJJJJJJJJJGGGGGGGGGGGGGGGGJMMMMMMMMPPP
GGGGGGGJJGJJJJJJJJGGGGGGGGGGGGGGGGGGGJJJMMMMMPPPMP
GGGGGGGGGGGJJJJGGGGGGGGGGGGGGGGGGGGGGJJJJMJMMMPMMP
GGGGGGGGGGGJJJJGGGGGGGGGGGGGGGGGGGGGGJJJMJJMMPMMMM
GGGGGGGGGGJJJJGGGGGGGGGGGGGGGGGGGGGGGJJJJJMMPMMMPM
GGGGGGGGJJJJJJGGGGGGGGGGGGGGGGGGGGGGJJJJJMMMMMMMMM
GGGGGGGJJJJJJJGGGGGGGGGGGGGGGGGGGGGJJJJJJMJMMMMMMM
GGGGGGGJJJJJJJGGGGGGGGGGGGGGGGGGGGGJJJJJJJJJJJJJJM
GGGGGGGJJJJJJJGGGGGGJGGGGGJJJGGGGGGGJJJJJJJJJJJJJJ
GGGGGGGJJJJJGGGGGGGGJJGGGJJJJGGGGGGGGJJJJJJJJJJJJJ
GGGGGGJJJJJJGJGGGGGGGJJGGJJGGGGGGGGJGJJJJJJJGJJJJJ
GGGGGGJJJJJJJJGGGGGGGJGGGGGGGGGGGGGGGGJGGGGGGGJJJJ
GGGGGJJJJJJJJJJGGGGGGGGGGGGGGGGGGGGGGGGGGGGGGGGGGG
GGGGGJJJJJJJJGGGGGGGGGGGGGGGGGGGDADGGGGGGGGGGGGGGG
GGGGGJJJJJJJGGGGGGGGGGGDADDDDAAAAAAAADAADDGGGGGGGG
GGGGJJJJJJJGGGGGGGDAAADAAAAAAAAAAAAAAAAAADGGDGGGGG
GGGGGGJJJJJGGGGGDDDAAAAAAAAAAAAAAAAAAAAAAAADDDGGGG
GGGGGJJJJGGGGGGGDDAAAAAAAAAAAAAAAAAAAAAAAAAADADDDG
GGGGGGJGGGGGGGGGGDDAAAAAAAAAAAAAAAAAAAAAAAAAAADDDD
GGGGGGJGGGGGGGGGGDDAAAAAAAAAAAAAAAAAAAAAAAAAAAAAAD
GGGGGGJGGGGGGGGGGDDAAAAAAAAAAAAAAAAAAAAAAAAAAAAAAA
GGGGGGGGGGGGGGGGDDAAAAAAAAAAAAAAAAAAAAAAAAAAAAAAAA
GGGGGGGGGGGGGGGGDDDAAAAAAAAAAAAAAAAAAAAAAAAAAAAAAA
GGGGGGGGGGGGGGGDDDDAAAAAAAAAAAAAAAAAAAAAAAAAAAAAAA
GGGGGGGGGGGGGGGDDDDAAAAAAAAAAAAAAAAAAAAAAAAAAAAAAA
GGGGGGGGGGGGGGDDAAAAAAAAAAAAAAAAAAAAAAAAAAAAAAAAAA
GGGJJGGGGGGGGGDAAAAAAAAAAAAAAAAAAAAAAAAAAAAAAAAAAA
GGGJGGGGGGGGGGDAAAAAAAAAAAAAAAAAAAAAAAAAAAAAAAAAAA
JGJJJJGGGGGGGDAAAAAAAAAAAAAAAAAAAAAAAAAAAAAAAAAAAA
JJJJJJJJGGGGGDAAAAAAAAAAAAAAAAAAAAAAAAAAAAAAAAAAAA
JJJJJJJJGGGGGDAAAAAAAAAAAAAAAAAAAAAAAAAAAAAAAAAAAA
JJJJJJJJGGGDAAAAAAAAAAAAAAAAAAAAAAAAAAAAAAAAAAAAAA
JJJJJJJGGGDDAAAAAAAAAAAAAAAAAAAAAAAAAAAAAAAAAAAAAD
JJJJJJJGGGDDADDDAAAAAAAAAAAAAAAAAAAAAAAAAAAAAAAAAA
