MMMJJJJGGGGGGGGGGGGGGGGGGGGGGGGGGGGGGGGGGGGGGGGGGG
MMMJJJJJGGGGGGGGGGGGGGGGGGGGGGGGGGGGGGGGGGGGGGGGGG
MMJJJJJJJGGGGGGGGGGGGGGGGGGGGGGGGGGGGGGGGGGGGGGGGG
MJJJJJJGGGGGGGGGGGGGGGGGGGGGGGGGGGGGGGGGGGGGGGGGGG
MJJJJJJJGGGGGGGGGGGGGGGGGGGGGGGGGGGGGGGGGGGGGGGGGG
JJJJJJJJGGGGGGGGGGGGGGGGGGGGGGGGGGGGGGGGGGGGGGGGGG
MJJJJJJGGGGGGGGGGGGGGGGGGGGGGGGGGGGGGGGGGGGGGGGGGG
JJJJJJGGGGGGGGGGGGGGGGGGGGGGGGGGGGGGGGGGGGGGGGGGGG
JJJJGGGGGGGGGGGGGGGGGGGGGGGGGGGGGGGGGGGGGGGGGGGGGG
JJJJJGGGGGGGGGGGGGGGGGGGGGGGGGGGGGGGGGGGGGGGGGGGGG
JJJJGGGGGGGGGGGGGGGGGGGGGGGGGGGGGGGGGGGGGGGGGGGGGG
JJGGJJGGGGGGGGGGGGGGGGGGGGGGGGGGGGGGGGGGGGGGGGGGGG
JGGGGJGGGGGGGGGGGGGGGGGGGGGGGGGGGGGGGGGGGGGGGGGGGG
JJGGGGGGGGGGGGGGGGGGGGGGGGGGGGGGGGGGGGGGGGGGGGGGGG
JJJGGGGGGGGGGGGGGGGGGGGGGGGGGGGGGGGGGGGGGGGGGGGGGG
JJJJGGGGGGGGGGGGGGGGGGGGGGGGGGGGGGGGGGGGGGGGGGGGGG
JJJJJGGGGGGGGGGGGGGGGGGGGGGGGGGGGGGGGGGGGGGGGGGGGG
JJJJJJGGGGGGGGGGGGGGGGGGGGGGGGGGGGGGGGGGGGGGGGGGGG
MJJJJJGGGGGGGGGGGGGGGGGGGGGGGGGGGGGGGGGGGGGGGJGJGG
JJJJJJGGGGGGGGGGGGGGGGGGGGGGGGGGGGGGGGGGGGGJJJJJJG
JJJJJJJGGGGGGGGGGGGGGGJGGGGGGGGGGGGGGGGGGGGJJJJJGG
JJJJJJJGGGGGGGGGGGGGGGGGGGGGGGGGGGGGGGGGGGJJJJJJJJ
JJJJJJGGGDGGGGGGGGGGGJGGGGGJJGGGGGGGGGGJGGJGJJJJJJ
JJJJJGGGDDDGGGGGGGGGGJJJGGJJJJJJJJGGGGGGGGGJJJJJJJ
JJJJGGGGDDDGGGGGGGGGGJJJJJJJJJJJJJJGGGGGGGGGJJJJJJ
JJGGGGGDDDDDDGGGGGGGGGGJJJJJJJJJJJJJGGGGGGGGJJJJJJ
JJGGGGGGDDDDDGGGGGGGGGJJJJJJJJJJJJJJGGJGGJJJJJJJJJ
JJGGGGGGGDDDGGGGGGGGGGJJJJJJJJJJJJJJGGJJJJJJJJJJJJ
JGGGGGGGDDDDGGGGGGGGGGJJJJJJJJJJJJJJJJJJJJJJJJJJJJ
JGGGGGGGGDDDDGGGGGGGJJJJJJJJJJJJJJJJJJJJJJJJJJJJJJ
JJGGGGGGDDDDDDDGGGGGGJJJJJJJJJJJJJJJJJJJJJJJJJJJJJ
JJGGGGGGDDDDDDDGGGGGGJJJJJJJJJJJJJJJJJJJJJJJJJJJJJ
JGGGGGGGGGDDDDDGGGGGGJJJJJJJJJJJJJJJJJJJJJJJJJJJJJ
JGGGGGGGGDDDDDDGGGGGGGGJJJJJJJJJJJJJJJJJJJJJJJJJJJ
JJGGGGGGGGGDDDDGGGGGGGGGJJJJJJJJJJJJJJJMMJMJMMJJJJ
JJGGGGGGDDDDDDDDGGGGGGGJJJJJJJJJJJJJJJJMJJJJJMMJJJ
JJGGGGGGDDDDDDDDDGGGGGGJJJJJJJJJJJJJJJJJJJJJJMMJMM
JGGGGGDGGDDDDDDDDGGGGGGJJJJJJJJJJJJJJJJJJMJJJMMMMJ
GGGGGDDDDDDDDDDDDGGGGGJJJJJJJJJJJJJJJJJJMMJJJMMMMM
GGGDDDDDDDDDDDDDGGGGGGJJJJJJJJJJJJJJMJMMJJJJJMMMMM
GGDDDDDDDDDDDDDGGGGGGJJJJJJJJJJJJJJJMMMMMJMMMJMMMP
GDDDDDDDDDDDDDDGGGGGJJJJJJJJJJJJJMJJMMMMMJMMMMJJMP
DDDDDDDDDDDDDDDGGGGJJJJJJJJJJJJJJJJJMMMMJMMMMMMMMP
DDDDDDDDDDDDDDGGGGGJJJJJJJJJJJJJJJMMMMMMMMMMPMMMPM
DDDDDDDDDDDDDDDGGGGJJJJJJJJJJJJJJJMMMMMMMMMPPPPPPP
DDDDDDDDDDDDDDDGGGGJJJJJJJJJJJJJJJJJMMJMMPPPPPPMPM
DDDDDDDDDDDDDDDGGGGGGJJJJJJJJJJJMMJJMMMMMPPPPPPPPM
DDDDDDDDDDDDDDDDGGGGGGGJGJJJJJJJJMJJMMMMMPMPPPPPPM
DDDDDDDDDDDDDDDDDGGGGGGGGGGJJJJJJJMMMMMMMMPPPPPPPP
DDDDDDDDDDDDDDDDDGGGGGGGGGGGJJJJJJMMMPMMMMPPPPPPPP
