PMMMJJJMMPPMMPPPPPPPMMMJJJJJJJJJJJJJJJJJJJJJJJJJMJ
MMMMJJJMMPMMPPPPPPPMMMJJJJJJJJJJJJJJJJJJJJJJJJJJJJ
PPMMMJJMMPPPPPPPPPPMMMJMMJJJJJJJJJJJJJJJJJJJJJJJJJ
PPPPMMMMMPPPPPPPPPMMJJMMMMJJJJJJJJJJJJJJJJJJJJJJJJ
PPPPPMJJJMMMPPPMMMMMJJJMMJJJJJJJJJJJJJJJJJJJJJJJJJ
PPPPPPMMJJJMPPPMMJJJMMJMJJJJJJJJJJJJJJJJJGJJJJJJJJ
PPPPPPMMJMJPJMMMJJJJJMMJJMJJJJJJJJJJJJJGGGJJJJJJJJ
PPPPPPMMMJMMMJMMJJJJJJMJMMJJJJJJJJJJJJGGGGGJJJJJJJ
PPMPPPPMJJPPMMPMJJJJJJJJJJJJJJJJJJJJJJJGGGJJJJJJJJ
PPPMPPMMMMMPPMMMJJJJJJJJJJJJJJJJJJJJJJJGGJJJJJJJJJ
PMPPPPMMMJMMPPMMMJJJJJJJJJJJJJJJJJJJGGGGJJJJJJJJJJ
PMMMJMMMMJPMMMMMJJJJJJJJJJJJJJJJJJJGGGGJJJJJJJJJJJ
MMMMMMPPMMPPMMMJJJJJJJJJJJJJJMJJJJJJGGGGJJJJJJJJJJ
PPMPPPPPPMPMMMMJJJJJJJJJJJJJJJJJJJJJGGJJJJGJJJJJJJ
PPMPPPPPPPMMJMJJJJJJJJJJJJJJJJJJJJJJGGGJGGGJJJJJJJ
MPPPPPPPPPMMMMJJJJJJJJJJJJJJJJJJJJJGGGGGGGGJJJJJJJ
MMMMMPPPPPMMMJJJJJJJJJJJJJJJJJJJJJJGGGGGGGGJJJJJJJ
MMPMMPPPPMMMJJJJJJJJJJJJJJJJJJJJJJJGGGGGGGGGJJJJGG
MMMPPPPPPMMMMJJJJJJJJJJJJJJJJJJJJJJGGGGGGGGGGJJGGG
PPPPPPPPPMMMJJJJJJJJJJJJJJJJJJJJJJJGGGGGGGGGGGGGGG
PPPPPPPPPMMMJJJJJJJJJJJJJJJJJJJJJJJGGGGGGGGGGGGGGG
PPPPPPPPPMMJJJJJJJJJJJJJJJJJJJJJJJGGGGGGGGGGGGGGGG
PPPMMMMMMMJJJJJJJJJJJJJJJJJJJJJJJJGGGGDGGGGGGGGGGG
MMMMMMMJMMJJJJJJJJJJJJJJJJJJJJJJJJGGGGDDGGGGGGGGGG
MMMMMMJJJJJJJJJJJJJJJJJJJJJJJJJJJJGGGDDDDGGGGGGGGG
MMMJMMJMJJJJJJJJJJJJJJJJJJJJJJJJJJGGGGGDDDDDGGGGGG
MMMMMMJMMJJJGGGJJJJJJJJJJJJJJJJJJJGGGGGGGDDDDGGGGG
MMMMMMMMMJJGGGGGJJJJJJJJJJJJJJJJJJJGGGGGDAAAAGGGGG
MJJJMMMMJJJJGGGGJJJJJJJJJJJJJJJJJJJGGGGDDAAAAGGGGG
MMJJMMMJJJJJGGGGGJJJJJJJJJJMJJJJJGGGGGDDAAAAADGDDD
MMMJMMMJJJJJJGGGJJJJJJJJJJJJJJJJJGGGGDAAAAAAAAAAAA
MMJMMMMMJJJJJGGGJJJJJJJJJJJJJJJJJGGGDAAAAAAAAAAAAA
JJJJMMMJJJJJJJJGJJJJJJJJJJJJJJJJGGGGDDAAAAAAAAAAAA
JJMMMMJJJJJJJJJGGJJJJJJJJJJJJJJJGGGDAAAAAAAAAAAAAA
JJJJJJJJJJJGGGGGGJJJJJJJJJJJJJJJGGGDAAAAAAAAAAAAAA
JJJJJJJJJJJGJGGGGGJGJJJJJJJJJJJJGGGDAAAAAAAAAAAAAA
JJJJJJJJJJGGGGGGGGGGGGJGJGGGJJJGGGGDAAAAAAAAAAAAAA
JJJJJJGJJGGGGGGGGGGGGGGGGGGGGGJGGGDDAAAAAAAAAAAAAA
JJJJGGGGGGGGGGGGGGGGGGGGGGGGGGGGGGDAAAAAAAAAAAAAAA
JJJJJGGGGGGGGGGGGGGGGGGGGGGGGGGGGGDAAAAAAAAAAAAAAA
JJJJJGGGGGGGGGGGGGGGGGGGGGGGGGGGGGGDDAAAAAAAAAAAAA
JJJJJJJGGGGGGGGGGGGGGGGGGGGGGGJGGGGGGGDAAAAAAAAAAA
JJJJJJJGGGGGGGGGGGGGGGGGGGGJJJJJGGGGGGGDAAAAAAAAAA
JJJJJJJGGGGGGGGGGGGGGGJJJJJJJJJJJJGGGGGGDDDAAAAAAA
JJJJJJJJJGGGGGGGGGGGGGGJJJJJJJJJJGGGGGGGGGGGDDDDDD
JJJJJJJJJJGGGGGGGGGGGGGJJJJJJJJJGGGGGGGGGGGGGGGGGG
JJJJJJJJJJJGGGGGGGGGGGGJJJJJJJJJJGGGGGGGGGGGGGGGGG
MJJJJJJJJJGGGGGGGGGGJJJJJJJJJJJJJGGGGGGGGGGGGGGGGG
JJJJJJMJJJGGGGGGGGGGGJJJJJJJJJJJJGJJJGGGGGGGGGGGGG
JMJMJMJJJJJGGGGGGGGGGJJJJJJJJJJJJJJJJGGGGGGJJGGGGG
