JJJJJJJJGGGGGGGGGGGGGGGGGGDAAAAAAAAAAAAAAAAAADGGGJ
JJJJJJJJJGGGGGGGGGGDDDDADDAAAAAAAAAAAAAAAAAAADGGGJ
JJJJJJJJJGGGGGGGGGDAAAAAAAAAAAAAAAAAAAAAAAAAAAGGGG
JJJJJJJJGGGGGGGGDDAAAAAAAAAAAAAAAAAAAAAAAAAADDGGGG
JJJJJJJGGGGGDGGDAAAAAAAAAAAAAAAAAAAAAAAAAAAAADGGGG
JJJJJJGGGGGGDGDDAAAAAAAAAAAAAAAAAAAAAAAAAAAAADGGGG
JJJJJJGGGGGGDGGDAAAAAAAAAAAAAAAAAAAAAAAAAAAAADGGGG
GGJGGGGGGGGDGDDDAAAAAAAAAAAAAAAAADADAAAAAAAAAADDGG
GGGGGGGGGDDGGGDAAAAAAAAAAAAAAAADDDDDAAAAAAAAAAAADG
GGGGGGGDDADDDDAAAAAAAAAAAAAAAADDDGGDAAAAAAAAAAAADG
GGGGGGGDDAAAAAAAAAAAAAAAAAAAAAAADDDDDDDDAAAAAAAADG
GGGGGGDDAAAAAAAAAAAAAAAAAAAAAAAAADDDDGGGGDDAAAADDG
GGGGGGDAAAAAAAAAAAAAAAAAAAAAAAAAAADGGGGGGGGDDAADDG
GGGGDDAAAAAAAAAAAAAAAAAAAAAAAAAAAADGGGGGGGGGGDDDGG
GGDAAAAAAAAAAAAAAAAAAAAAAAAAAAAADDGGGGGGGGGGGGGDGG
GDAAAAAAAAAAAAAAAAAAAAAAAAAAAAADGGGGGGGGGGGGGGGDDD
AAAAAAAAAAAAAAAAAAAAAAAAAAAAAAADGGGGGGGGGGGGGGGDGD
AAAAAAAAAAAAAAAAAAAAAAAAAAAAAADGGGGGGGGGGGGGGGGGGG
AAAAAAAAAAAAAAAAAAAAAAAAAAAAAADGGGGGGGGJJJJGGGGGGG
AAAAAAAAAAAAAAAAAAAAAAAAAAAAAADGGGGGGGGJJJGGGGGGGG
AAAAAAAAAAAAAAAAAAAAAAAAAAAAADGGGGGGGGGGGGGGGGGJJG
DDAAAAAAAAAAAAAAAAAAAAAAAAAADDDGGGGGGGGGGGGGGJJJJJ
DDDAAAAAAAAAAAAAAAAAAAAAAAADDDGGGGGGGGGGGGGGGJJJJJ
DDDAAAAAAAAAAAAAAAAAAAAAAADDDGGGGGGGGGGJGGGJJJJJJJ
GGGDDDAAAAAAAAAAAAAAAAAAAADDDGGGGGGGGGGJJJJJJJJJJJ
GGGGGDDDAADAAAAAAAAAAAAAAADDGGGGGGGGJJJJJJJJJJJJJJ
GGGGGGGDDDDDDAAAAAAAAAAAAAADGGGGGGGGGGJJJJJJJJJJJJ
GGGGGGGDGGGGDDDDAAAAAAAAAAAADGGGGGGGGGJJJJJJJJJJJJ
GGGGGGGGGGGGGGGGGDAAAAAAAAAADGGGGGGGGGJJJJJJJJJJJJ
GGGGGGGGGGGGGGGGGDAAAAAAAAAADGGGGGGGGJJJJJJJJMMJJJ
GGGGGGGGGGGGGGGGGDDAAAAAAAAADGGGGGGGJJJJJJJJMMMMMM
GGGGGGGGJGJGGGGGGGDDAAAAAAAADGGGGGGGJJJJJJJMMMMMMM
GGGGGGJJJJGGGGGGGGGGDDDAAAAADGGGGGGJJJJJJJJMMMMMJM
GGGGGGJJJJGGGGGGGGGGGGGDDDAADGGGGGGJJJJJJJJMMMMMMM
GGGGGGGGJGGGGGGGGGGGGGDDDDAAADGGGGJJJJJJJJJMMMMMMM
GGGGGGGGGGGGGGGGGGGGGGDDDDDDDGGGGJJJJJJJJJMMMMMMMM
GGGGGGGGGGGGGGGGGGGGGGGDDDDDGGGGJJJJJJJJJJMMMMPPMM
GGGGGGGGGGGGGGGGGGGGGGDDDDGGGGJJJJJJJJJJJMMMMMPPMM
GGGGGGGGGGGGGGGGGGGGGGGDDDGGGJJJJJJMJJJJJJMMMPPPPM
GGGGGGGGGGGGGGGGGGGGGGGDGGGGGJJJJJJJMMJJJMMPPPPPPP
GGGGGGGGGGGGGGGGGGGGGGGGGGGGGJJJJJJJMMMMMMPPPPPPPP
GGGGGGGGGGGGGGGGGGGGGGGGGGGJJJJJJJMMMMMMMPPPPPPPPP
GGDDGGGGGGGGGGGGGGGGGGGGGJJJJJJJJJMMMMMMPPPPPPPPPP
DDDDDDDDDGGGGGGGGGGGGGGGGJJJJJJJJMMMMMMMMPPPPPPPPP
DDDDDDDDDGGGGGGGGGGGGGGGJJJJJJJMMMMPPPMPMPPPPPPPPP
DDDDGGGDDGGGGGGGGGGGGGGJJJJJMMMMMMPPPPPPPPPPPPPPPP
DDDDGGGGDGGGGGJGGGGJJJJJJJJMMMMMPPPPPPPPPPPPPPPPPP
DDDDGGGGGGGGGJJJJGGJJJJJJJJJMMMMPPMPPPMPPPMPPPPPPP
GDDDGGGGGGGGJJJJJJJJJJJJJJJMMMMMMMMJMPMPPMMPMPPPPP
GGGGGGGGJJGGJJJJJJJJJJJJJMJMMMMMMMJJMPPMPJMPMPPPPP
