JJJJJJJJJJJJJJJJJJJJJJJGGGGDDDDDDDGGGGGGDDGGGGGGJG
JJJJJJJJJJJJJGGJJJJJJJGGGGDAAAAAADDGGGGDDDGGGGGGGG
JJJJJJJJJJJJJJGGGJGGGGGGDDDAAAAAAADDDDAAAADDGGGGGG
JJJJGJJJGJJJJJJGGGGGGGDAAAAAAAAAADDAADAAAAADADGGGG
JJJGGGGGGJJJJJGGGGGGGDAAAAAAAAAAAAAAAAAAAAAAAAAGGG
JJJJGGGGGGJJGGGGGGGGGAAAAAAAAAAAAAAAAAAAAAAAAAADGG
JJJGGGGGGGGGGGGGGGGDDAAAAAAAAAAAAAAAAAAAAAAAAAAAAD
JJJJGGGGGGGGGGGDDDGAAAAAAAAAAAAAAAAAAAAAAAAAAAAAAA
JJJJGGGGGGGGGDDDDAAAAAAAAAAAAAAAAAAAAAAAAAAAAAAAAA
JJJJJGGGGGGGDDAAAAAAAAAAAAAAAAAAAAAAAAAAAAAAAAAAAA
JJJGGGGGGGGGGDAAAAAAAAAAAAAAAAAAAAAAAAAAAAAAAAAAAA
JJJGGGGGGGGGDDAAAAAAAAAAAAAAAAAAAAAAAAAAAAAAAAAAAA
JJGGGGGGGGGGDAAAAAAAAAAAAAAAAAAAAAAAAAAAAAAAAAAAAA
JJGGGGGGGGGGGDAAAAAAAAAAAAAAAAAAAAAAAAAAAAAAAAAAAA
JJJJGGGGGGGGGDAAAAAAAAAAAAAAAAAAAAAAAAAAAAAAAAAAAA
JJJJGGJGGGGGGGDAAAAAAAAAAAAAAAAAAAAAAAAAAAAAAAAAAA
JJJJJJJGGJJGGGGAAAAAAAAAAAAAAAAAAAAAAAAAAAAAAAAAAA
JJJJJJJJJJJGGGGDDAAAAAAAAAAAAAAAAAAAAAAAAAAAAAAAAA
JJJJJJJJJJJJJGGGGDDAAAAAAAAAAAAAAAAAAAAAAAAAAAAADD
JJJJJJJJJJJJJGGGGDDDDDAAAAAAAAAAAAAAAAAAAAAAAADADD
JJJJJJJJJJJJJGGGGGGDDDDAAAAAAAAAAAAAAAAAAAAAAADDDG
JJJJJJJJJJJJJJGGGGGGGGDADDAAAAAAAAAAAAAAAAAAAADDAD
JJMMJJJJJJJJJJGGGGGGGGDDDDADDDAAAAAAAAAAAAAAAADDAA
JJMJJJJMMJJJJJJGGGGGGGDDDDDDDDAAAAAAAAAAAAAAADAAAA
JJJJJJMMMMMJJJJGGGGGGGDDDDDGGDAAAAAAAAAAAAAAAAAAAA
JJJJJMMMMMMMJJJJGGGGGDGGGGGGGDADDDDDDDGDDAAAAAAAAA
JJJJJMMJJMMJJJJJGGGGDDGGGGGGGGDDDDDGGGGGGGDDAAAADA
JJJJJJJJJMMJJJJJJGGGGGGGGGGGGDDDGGGGGGGGGGGGGDDDDD
JJJJJJJJMMMJJJJJJJGGGGGGGGGGGGDDGGGGGGGGGGGGGGGGGG
JJJJJJJMMMJJJJJJJJGGGGGGGGGGGGGGGGGGGGGGGGGGGGGGGG
JJJJMMMJMMJJJJJJJJJJGGGGGGGGGGGGGGGGGGGGGJJJJJGGGG
JMMMMMMMMMMJJJJJJJJJJGGGGGGGGGGGGGGGGGGJJJJJJJJGGG
MMMMMMJMMJJJJJJJJJJJJJJJJGGGGGGGGGGGGGGJJJJJJJJJGG
MMMJJJJJJJMJJMJJJJJJJJJJJJGGGGGGGGGGGGJJJJJJJJJJJG
MMMJMMMMMMMMMMMMJJJJJJJJJJGGGGGGJJGGGJJJJJJJJJJJJJ
MMJMMMMJMJMMMMMMJJJJJJJJJJJJJGGJJGGJJJJJJJJJJJJJJJ
PMMMMPPMMJMMMMMMMMMMMMMMJJJJJJGGGJJJJJJJJJJJJJJJJJ
MMMPPPMMMMPPPMMMMMMMMMMJJJJJJJJGGJJJJJJJJJJJJJJJJG
MMMMPPPMPPPPPMMMMMMMMMMJJJJJJJJJJJJJJJJJJJJJJJJJJJ
PMMMPPPPMPPPPMMJMJJMJMJJJJJJJJJJJJJJJJJJJJJJJJJJJJ
PPMMPPPPPPPPMMMMJJJJJJJJJJJJJJJJJJJJJJJJJJJJJJJJJJ
MMMMPMPPPPPPPMMMJJJJJJJJJJJJJJJJJJJJJJJJJJJJJJJJJJ
MPMPMPMPPPPPMMMJJJJJJJJJJJJJJJJJJJJJJJJJJJJJJJJJJJ
PMMMMMPPMPMMPPMMJJJJJJJJJJJJJJJJJJJJJJJJJJJJJJJJJJ
PPMMMMMMMMMMMMMJJJJJJJJJJJJJJJJJJJJJJJJJJJJJJJJJJJ
MMMPMMMMMMMMMMJJJJJJJJJJJJJJJJJJJJJJJJJJJJJJJJJJJJ
MJMMPPPPPMMMMJJJJJJJJJJJJJJJJJJJJJJJJJJJJJJJJJJJJJ
MJMMMMPMMMJJJJJJJJJJJJJJJJJJJJJJJJJJJJJJJJJJJJJJJJ
MJMMMMMMMJJJJJJJJJJJJJJJJJJJJJJJJJJJJJJJJJJJJJJJJJ
JJJJMMMMMJJJJJJJJJJJJJJJJJJJJJJJJJJJJJJJJJJJJJJJJJ
