AAAAAAAAAAAAAAAAAAAAAAAAADDDDDDGGGGGJJJJJJJJJJJJJJ
AAAAAAAAAAAAAAAAAAAAAAAAAAADDDGGGGGGGGJJJJJJJJJJJJ
AAAAAAAAAAAAAAAAAAAAAAAAAAAADDGGGGGGGGJJJJJJJJJJJJ
AAAAAAAAAAAAAAAAAAAAAAAAAAAAADDGGGGGGGJJJJJJJJJJJJ
AAAAAAAAAAAAAAAAAAAAAAAAAAAAAAAGGGGGGGJJJJJJJJJJJJ
AAAAAAAAAAAAAAAAAAAAAAAAAAAAAAADGGGGGJJJJJJJJJJJJJ
AAAAAAAAAAAAAAAAAAAAAAAAAAAAAAADDGGGJJJJJJJJJJJJJJ
AAAAAAAAAAAAAAAAAAAAAAAAAAAAAAAAGGGGJJJJJJJJJJJJJJ
AAADAAAAAAAAAAAAAAAAAAAAAAAAAAAADGGGJJJJJJJJJJJJJJ
AAAADAAAAAAAAAAAAAAAAAAAAAAAAAAADGGGJJJJJJJJJJJJJJ
DADDDDAAAAAAAAAAAAAAAAAAAAAAAAAADGGGGJJJJJJJJJJJJJ
DDADDDDAAAAAAAAAAAAAAAAAAAAAAAAAADGGGGJJJJJJJJJJJJ
DAADDDDDAAAAAAAAAAAAAAAAAAAAAAAAAAGGGGJJJJJJJJJMMJ
DDADDDDAAAAAAAAAAAAAAAAAAAAAAAAAAADGGGJJJJJJJJJMJJ
GDDDDAAAAAAAAAAAAAAAAAAAAAAAAAAAAADGGGGJJJJJJJJJJJ
GGDDAAAAAAAAAAAAAAAAAAAAAAAAAAAAAAAAGGGGGJJJJJJJJJ
GGGDDAAAAAAAAAAAAAAAAAAAAAAAAAAAAAAADGGGGJJJJJJJJJ
GGGGDDAAAAAAAAAAAAAAAAAAAAAAAAAAAAAAADGGGGJJJJJJJJ
GGGGGDAAAAAAAAAAAAAAAAAAAAAAAAAAAAAADGGGGGJJJJJJJJ
GGGGGDAAAAAAAAAAAAAAAAAAAAAAAAAAAAAADGGGGGJJJJJJJJ
GGGGDDDAAAAAAAAAAAAAAAAAAAAAAAAAAAADDGGGGGGJJJJJJJ
GGGGGGDAAAAAAAAAAAAAAAAAAAAAAAAAAADDDGGGGGGJJJJJJJ
GGGGGGDAAAAAAAAAAAAAAAAAAAAAAADDDDDDGGGGGJJJJJJJJJ
GGGGGGGDAAAAAAAAAAAAAAAAAAAAADDDDDGDGGGGGGGGJJJJJJ
JJJGGGGGAAAAAAAAAAAAAAAAAAAAADDGGGGGGGGGGGGGGJJJJJ
JJJGGGGGGAAAAAAAAAAAAAAAAAAADGGGGGGGGGGGGGGGGGGJGJ
JJJJGGJGGAAAAAAAAAAAAAAAAADDGGGGGGGGGGGGGGGGGGGGGJ
JJJJJJJGGDAAAAAAAAAAAAAAAADGGGGGGGGGGGGGGGGGGGGGGJ
JJJJJJGGGGDAAAAAAAAAAAAAADGGGGGGGGGGGGGGGGGGGGGGJJ
JJJJJGGGGGDDAAAAAAAAAAAADGGGGGGGGGGGGGGGGGGGGGGGJJ
JJJJJJGGGGGGDDDAAAAAAAADGGGGGGGGGGGGGGGGGGGGGGJJJJ
JJJJJJJGGGGGGGGGDDAAAADGGGGGGGGJJGGGGGGGGGGGGGGJJJ
JJJJJJJGGGGGGGGGDDDDDGGGGGGGGGGGGGGGGGGGGGGGGGGJJJ
JJJJJJJJGJJJJGGGGGGGGGGGGGGGGGGGJJJGGGGJGGGGGGGGJJ
JJJJJJJJJJJJJJGGGGGGGGGGGGGGGGGJJJJJJGJJGGGGGGGGGJ
JJJJJJJJJJJJJGGGGGGGGGGGGGGGGGGJJJJJJJJGGGGGGGGGJJ
JJJJJJJJJJJJJJJGGGGGGGGGGGGGGGJJJJJJJJJGGGGGGGGGGG
JJJJJJJJJJJJJJJGGGGJJGJGJJJJJJJJJJJJJJJJGGGGGGGGGG
MJJJJJJJJJJJJJJJGGJJJJJJJJJJJJJJJJJJJJJJGGGGGGGGGG
MJJJJJJJJJJJJJJJGGJJJJJJJJJJJJJJJJJJJJJGGGGGGGGGGG
MJJJJJJJJJJJJJJJJJJJJJJJJJJJJJJJJJJJJGJJGGGGGGGGGG
MMJJJJJJJJJJJJJJJJJJJJJJJJJJJJJJJJJJJJJJJGGGGGGGGG
MMMMMJJJJJJJJJJJJJJJJJJJJJJJJJJJJJJJJJJJGGGGGGGGGG
PMMMMJJJJJJJJJJJJJJJJJJJJJJJJJJJJJJJJJJJGGGGGGGGGG
PPPMMMJJJJJJJJJJJJJJJJJJJJJJJJJJJJJJJJJGJJGGGGGGGG
PPPPMMMMMMMJJJJJJJJJJJJJJJJJJJJJJJJJJJJJJJGGGGGGGG
PPPMPMMMMMMMMJMJMJJJJJJJJJJJJJJJJJJJJJJJGGGGGGGGGG
PPPMMMMMMMMJMJJJMMJJJJJJJJJJJJJJJJJJJJJJJJGGGGGGGG
PPPPPMMMMMJJJJJJMMJJJJJJJJJJJJJJJJJJJJJJJJJGGGGGGG
PPMPMMMMMJJJMMMMMMMJJJJJJJJJJJJJJJJJJJJJJJJJGGGGGJ
