GGGGGGGGGGGGGGGGGGGJJJJJMMMMJJMJMPPMPPPPPPPPPPPPPM
GGGGGGGGGGGGGGGGGGGJJJJJMMMMJMMMMMPPPPPPPPPPPPPPPP
GGGGGGGGGGGGGGGGGGJJJJJMMMJJJMPPPMMPPMMPPPPPPPPPPP
GGGGGGGGGGGGGGGGGGJJJJJJMMJMMMMPPPMPPPMPPPPPPPPPPP
GGGGGGGGGGGGGGGGGGJJJJJJJJJMMMPMPPMMPPPPPMPPPPPPPP
JGGGGGGGGGGJGGGGGGJJJJJJJJMMMMPMMMMMMMMMMPPPPPPPPP
JJGGGGGGGGJJJJGJJJJJJJJJJJMMMMMMMPMMMMPPMMPPPPPPPM
JJGGGGGGGGJJJJJJJJJJJJJJJJJMMPPMMMMMMMMMMMPPPPPPPM
JJJGGGGGGGGJJJJJJJJJJJJJJJMMMPPMMPMMMMMMMMMMMPPPMM
JJGGGGGGGGGJJJJJJJJJJJJJJJJMMMPMMMMMJMMMMMMMMPPMMM
JJJGGGGGGJJJJJJJJJJJJJJJJJJMMPPMMMMMJJJMJMMMMMMMMJ
JJJJJJGGJJJJJJJJJJJJJJJJJJMMMPPPMMMMJJJMMJMMMMMMJJ
JJJJJJJJJJJJJJJJJJJJJJJJJJMMMMPMMMJJJJJMJMMMMMMMMM
JJJJJJJJJJJJJJJJJJJJJJJJJJMMMMMMMMJJJJJJMMMMMJMMJJ
JJJJJGGGGGGJJJJJJMJJJJJJJJJMMMMMMMMJJJJJMMMMJJJJJJ
JJJJJGGGGGGJJJJJJJJJJJJJJJJJMMMMMMMJJJJMMMMJJJJJJJ
JJJJJGGGGGGGJJJJJJJJJJJJJJJJJMMMMJMJJJJJMMJJJJJJJJ
JJJJGGGGGGGGGJJJJJJJJJJJJJJJJJJJJJMJJJJJJJJJJJJJJJ
JJJGGGGGGGGGGGJJJJJJJJJJJJJJJJJJJJJJJJJJJJJJJJJJGJ
JJGGGGGGGGGGGGGGGGGJJJJJJJJJJJJJJJJJJJJJJJJJJJGGGG
JJJJGGGGGGGGGGGGGGGGGGJGGJGGJJJJGJJJJJJJJJJJJJGGGG
JJJJGGGGGGGGGGGGGGGGGGGGGJGGJJGGGGJJJJGGGGGJJGGGGG
JJJJGGGGGGGGDDDDDGGGGGGGGGGGGGGGGGJJGGGGGGGJGGGGGG
JJGGGGGGGDDAAAAAAGGGGGGGGGGGGGGGGGGGGGGGGGGGGGGGGG
JJGGGGGGDDAAAAAADDGGDGGDDGGGGGGGGGGGGGDGGGGGGGGGGG
GGGGGGGGGDAAAAAADDDDDAAAAADDGDGGGGGGGDDGGGGDDDDGGG
JJGGGGGGDAAAAAADDDDAAAAAAAAAAAADGDDAAADGGGGGDDDDDG
JJJGGGGDDAAAADADDDDAAAAAAAAAAAAADAAAAADGDGGGDDDDDD
JJGGGGDDAAAAAADDDDDAAAAAAAAAAAAAAAAAAAADDGGGDDDDDD
JGGGGGDDADAAAADAADDAAAAAAAAAAAAAAAAAAAAADGGGDDDDDD
GGGGGGDAAAAAAAAAAAAAAAAAAAAAAAAAAAAAAAAAADDDGDDDDD
GGDDDDDAAAAAAAAAADAAAAAAAAAAAAAAAAAAAAAAADGGDDDDDD
GGDDAAAAAAAAAAAAAAAAAAAAAAAAAAAAAAAAAAAAADDGDDDDDD
GAAAAAAAAAAAAADDDDAAAAAAAAAAAAAAAAAAAAAAADDDDDDDDD
DAAAAAAAAAAAAAAADDAAAAAAAAAAADAAAAAAAAAAAAADDDDDDD
AAAAAAAAAAAAAAAADAAAAAAAAAAAAAAAAAAAAAAAAAADDDDDDD
AAAAAAAAAAAAAAADDAAAAAAAAAAAAAAAAAAAAAAAAAAADDDDDD
AAAAAAAAAAAAAAAADAAAAAAAAAAAAAAAAAAAAAAAAAAADDDDDD
AAAAAAAAAAAAAAAAAAAAAAAAAAAAAAAAAAAAAAAAAAAAADDDDG
AAAAAAAAAAAAAAAAAAAAAAAAAAAAAAAAAAAAAAAAAAAAAAADDG
AAAAAAAAAAAAAAAAAAAAAAAAAAAAAAAAAAAAAAAAAAAAAAADGG
AAAAAAAAAAAAAAAAAAAAAAAAAAAAAAAAAAAAAAAAAAAAAAAGGG
AAAAAAAAAAAAAAAAAAAAAAAAAAAAAAAAAAAAAAAAAAAAAADGGG
AAAAAAAAAAAAAAAAAAAAAAAAAAAAAAAAAAAAAAAAAAAAADDGGG
AAAAAAAAAAAAAAAAAAAAAAAAAAAAAAAAAAAAAAAAAAAAADDGGG
AAAAAAAAAAAAAAAAAAAAAAAAAAAAAAAAAAAAAAAAAAAADDGGGG
AAAAAAAAAAAAAAAAAAAAAAAAAAAAAAAAAAAAAAAAAAADDGGGGG
AAAAAAAAAAAAAAAAAAAAAAAAAAAAAAAAAAADDDDDDDDGGGGGGG
AAAAAAAAAAAAAAAAAAAAAAAAAAAAAAAAAADGGGGGGGGGGGGGGG
AAAAAAAAAAAAAAAAAAAAAAAAAAAAAAAAADGGGGGGGGGGGGGGGG
