JJJJJJGGGGGGGGGGGGDGGGGGGGGGGDDGDDADADADGGGGGGGGJJ
JGJJGGGGGGGGDGGGDDDGGGGGGGGGDDAAAAAAAAAADDGGGGGGGJ
JGGGGGGGGGGDADDDAADGGGGGGGGDDAAAAAAAAAAAAAADDDGGGJ
GGGGGGGGDDDAAAAAAAADDGGGDDDAAAAAAAAAAAAAAAAAAADGGG
GGGGGGGGDAAAAAAAAAAAAADDDAAAAAAAAAAAAAAAAAAAAAADGG
GGDDGDDDAAAAAAAAAAAAAAAAAAAAAAAAAAAAAAAAAAAAAAAADG
GGDADAAAAAAAAAAAAAAAAAAAAAAAAAAAAAAAAAAAAAAAAAADDG
GGDAAAAAAAAAAAAAAAAAAAAAAAAAAAAAAAAAAAAAAAAAAAADGG
GGGDAADAAAAAAAAAAAAAAAAAAAAAAAAAAAAAAAAAAAAAAAADDG
GGGGDDDAAADDDADAAAAAAAAAAAAAAAAAAAAAAAAAAAAAAAADGG
GGGGGGDAADGGDDDDDAAAAAAAAAAAAAAAAAAAAAAAAAAAAAADGG
GGGGGGGDDDGGGGGGGDDAAAAAAAAAAAAAAAAAAAAAAAAAAAADGG
JJGGGGGGDGGGGGGGGGDAAAAAAAAAAAAAAAAAAAAAAAAAAAAADG
JJJGGGGGGGGGGGGGGGDDAAAAAAAAAAAAAAAAAAAAAAAAAAAADG
JJJJGGGGGGGGGGGGGGDDAAAAAAAAAAAAAAAAAAAAAAAAAAAADG
JJJJJGGGGGGGGGGGGGDAAAAAAAAAAAAAAAAAAAAAAAAAAAAADG
JJJJJGGGGGGGGGGGGGDAAAAAAAAAAAAAAAAAAAAAAAAAAAAADG
JJJJJJJGGGGGGGGGGGGAAAAAAAAAAAAAAAAAAAAAAAAAAAAADG
JJJJJJJJGGJJJGGGGGGDAAAAAAAAAAAAAAAAAAAAAAAAAAADGG
JJJJJJJJJJJJJJJGGGGDDDAAAAAAAAAAAAAAAAAAAAAAAAADGG
JJJJJJJJJJJJJJJJGGGGGDAAAAAAAAAAAAAAAAAAAAAAAAADGG
JJJJJJJJJJJJJJJJJGGGGGDAAAAAAAAAAAAAAAAAAAAAAAADGG
JJJJJJJJJJJJJJJJGGGGGGDDAAAAAAAAAAAAAAAAAAAAAAADGG
JJJJJJJJJJJJJJJJGGGGGGGDDAAAAAAAAAAAAAAAAAAAAAADGG
JJJJJJJJJJJJJJJJJJGGGGGGDDAAAAAAAAAAAAAAAAAAADDDGG
JJJJJJJJJJJJJJJJJJGGGGGGGDDAAAAAAAAAAAAAAAADGDDDGG
JJJJJJJJJJJJJJJJJJGGGGGGGGGGGDAAAAAAAAAAADAADDDGGG
JJJJJJJJJJJJJJJJGJGGGGGGGGGGGGDDAAAAAAAADDAAADDDGG
GJJJJJJJJJJJJJJJGGGGGGGGGGGGGGGGDAAAAAAADDDAADDDGG
GGGGJJJJJJJJJJJJJJJGGGGGGGGGGGGGGAAAADDADDDDDDDGDG
GGGGGJGJJGGJJJJJJJJJJGGGGGGGGGGGGDAADAADDAAADGGGGG
GGJJJJJJJJGGJJJJJJJJJGGGGGGGGGGGGDDADAAAAAADDGGGGG
JJJJJJJGGJJJJJJJJJJJJJJGGGGGGGGGGGDAAAAAAAAAGGGGGG
GJJJGJJJGGGGGJJJJJJJJJJJJJGGGGGGGDDAAAAAAAAAGGGGGG
JJJJGGGJGGGGJJJJJJJJJJJJJJJJGGGGGDDAAAAAAAADGGGGGG
JJJJJGGGJJJJJJJJJJJJJJJJJJJJGGGGGGDAAAAAAADDGGGGGG
JJJJJJJJJJJJJJJJJJJJJJJJJJJJGGGGDDAAAAAAAADDGGGGJJ
JJJJJJJJJJJJJJJJJJJJGGGGGGGGGGGGDDAAAAAAAADDGGGJJJ
JJJMJJJJJJJJJJJJJJJJJGGGJGGGGGGGGDAAAAAAAAGDGGJJJJ
MJMMJJJJJJJJJJJJJJJJJGGGGJGGGGGGGDAAAAAAADDDGGJJJJ
MMMMJJJJJJJJJJJJJJJGGGGGJJJGGGGGDAAAAAAAADDDGGJJJJ
MMMMJMJMMJJJJJJJJJJJGGJJJJJJGGGGDDAAAAAADDDGGJJJJJ
PJMMJJMMMJJJJJJJJJJJJJJJJJJJGGGGGGDAAAAADDGGGJJJJJ
MMJJJMJMMMMJJJJJJJJJJJJJJJJJJGGGGGGGAAAADDGGGJJJJJ
PMMJJJJMMMMMJJJJJJJJJJJJJJJJJGGGGGGGGDDAGGGGJJJJJJ
PPMMMJJMMMJMJJJJJJJJJJJJJJJJGGGGGGGGGGGGGGGGJJJJJJ
PPMMMJJMMMMMJMJJJJJJJJJJJJJGGGGGGGGGGGGGGGGGJJJJJJ
PPPPMJJMMMMMJJJJJJJJJJJJJJJGGGGJGGJGGJGGGGGGJJJJJJ
PPPPMMJMMJMMJJJJJJJJJJJJJJGGGGGJGGJJJJJJGGJGJJJJJJ
PPPPMMMMMMMMMMJJJJJJJJJJJJJGGGGGGGJJJJJJJJJJJJJJJJ
