JJJJJJJJJJJJJGGJJGJJJJJJGJJJJJMMMMMPMMMJMJMPMMJMMP
JJJJJJJJJJJJJJJJJJJJJJJJJJJJJJJMMPPPMMMMMMMPJMJJPP
JJJJJJJJJJJJJJJJJJJJJMJJJJJJMMMPPPPPMPPJMMMMJMJJMP
JJJJJJJJJJJJJJJJJJJJJJJJJJJJMMMPPPMMMMMMMJJJJMMMPM
JJJJJJJJJJJJJJJJJJJJJJJJJJMMJMPPPPMMMMMMJMMMJMMPPP
JJJJJJJJJJJJJJJJJJJJJMJJJJMMJMMPPPPMMMMMJMPPPPPPPP
JJGGGGGGGJJJJJJJJJJMJJJJJJMMMMMMPPPPMMJMPMMMPPPPPP
JJGGGGGGGGGGJJJJJJMJJJJJJJMMPMMMPMMMMMJPMMMJMPPPPP
JGGGGGGGGGGGJJJJJMMJJJJJJMMPPPMMMPPPMMMJPMMMMPPPPP
JGGGGGGGGGGGGJJJJJJJJJJJMMPPMMMMMMMMMMMMMJJJMPPPPP
GGGGGGGGGGGGGJJJJJJJJJJMMMMPPPMMMMMJMMMMJJMMPPPPPP
GGGGGGGGGGGGGJJGGJJMJJMJMMMMMMMJJMJJJJMJPMMMPPPPMP
GGGGGGGGGGGGGJGGGJJJJJJMMMMMMJJJMJJJJJMMPPMPPPPPPP
GGGGGGGGGGGGGGGGJJJJJMMMMMMPMJJMJJJJJJMMMMMPPMJMPP
GGGGGGGGGGGGGGGGJJJJJJMMMMMMMMMJJJJJJJJJMMMMMPMJMP
GGGGGGGGGGGGGGGGJJJJJMMMMMMMMMMJJJJJJJJJJMMMPMMJMM
GGGGGGGGGGGGGGGGGJJJJMMMMMJJMMMJJJJJJJJJJJMPMPMMJM
GGGGGGGGGGGGGGGGGJJJJMMMMMMMJJJJJJJJJJJJJJMMJMMMMP
GGGGGGGGGGGGGGGGGJJJJMJJMJJMMJJJJJJJJJJJJJMMJJMMPP
GGGGGGGGGGGGGGGGGJJJJMJMMMJJJJJJJJJJJJJJJJMMMJMMMM
GGGGGGGGGGGGGGGGGJJJJJJJMMJJJJJJJJJJJJJJJJJJMMMMPM
GGGGGGGGGGGGGGGGGGJJJJJJJMMJJJJJJJJJJJJJJJMMMMMPMM
GGGGGGGGGGGGGGGGGJJJJJJMJMMMMJJJJJJJJJJJJJJMMMMMMM
GGGGGGGGGGGGGGGGGGJJJJJJJJJJMJMJJJJJJJJJJJJMMMMMMM
GGGGGGGGGGGGGGGGGJJJJJJJJJJJMMJJJJJJJJMJJJMMMMMMMM
GGGGGGGGGGGGGGGGGJJJJJJJJJJJMMJJJJJJJJJJJJMMMMMMMJ
GGGGGGGGGGGGGGGGGGGJJJJJJJJMMMMJJJJJJJJJJJMMMMJJJJ
GGGGGGGGGGGGGGJGGGGGJJJJJJJMMJJJJJJJJJJJJJJJMJJMJJ
GGGGGGGGGGGGGJJJGGGGJJJJJJJJJJJJJJJJJGGJJJJJJJJJJJ
GGGGGGGGGGGGJJJJJJJJJJJJJJJJJJJJJJJJJGGGJJJJJJJJJJ
GGGGGGGGGGGGGJJJJJJJJJJGGGGJJJJJJJGGGGGJJJJJJJJJJJ
GGGGGGGGGGGGGJJJJJJGGJJGGGGGGGGGJGGGGGGGJJJJJJJJJJ
GGGGGGGGGGGGGGJJJJJGJJJJGGGGGGGGGGGGGGGGJJJJJJJJJJ
GGGGGGGGGGGGGGGGJGJGJJJJGGGGGGGGGGGGGGGGJJJJJJJJJJ
GGGGGGGGGGGGGGGGJGGGJJJJGGGGGGGGGGGGGGGGGJJJJJJJJJ
GGGGGGGGGGGGGGGJJGGGGGGGGGGGGGGGGGGGGGGGGGJJJJGGJJ
GGGGGGGGGGGGGGGGGGGGGGGGGGGGGGGGGGGGGGGGGGGGGGGGGG
GGGGGGGJJJGGGGGGGGGGGGGGGGGGGGGGGGGGGGGGGGGGGGGGGG
GGGGGGGGJJGGGGGGGGGGGGGGGGGGGGGGGGGGGGGGGGGGGGGGGG
GGGGGGGGGGGGGGGGGGGGGGGGGDDGGGGGGGGGGGGGGGGGGGGGGG
GGGGGGGGGGGGGGGDDDDDGGGGGAADDGGGGGGGDGGGGGGGGGDGGD
GGGGGGGGGGGGGGGDDDDDGGGGGDAAADGGGGGGDDDADGGGGDAAAA
GGGGGGGGGGGGGGGDDDDDDGDDDAAAADDDGGGGAAAAAAADDAAAAA
GGGGGGGGDADADDGDDDDDDGDDDAAAAAAADDGDDAAAAAADAAAAAA
GGGGGGGDAAAAAADDAAADDDDDAAAAAAAAAADDAAAAAAAAAAAAAA
GGDDDGGGAAAAAAAAAAAAAAAAAAAAAAAAAAAAAAAAAAAAAAAAAD
DDDDGGGGDAAAAAAAAAAAAAAAAAAAAAAAAAAAAAAAAAAAAAAADG
GDDDDDDDDAAAAAAAAAAAAAAAAAAAAAAAAAAAAADAAAAAAAADAA
GGDDDDDAAAAAAAAAAAAAAAAAAAAAAAAAAAAAAAAAAAAAAAADAA
GGDDDDDADDAAAAAAAAAAAAAAAAADDDDDAAAAAADAAAAAAADDAA
