GGGGGGGGGGGGGGGGGGGGGGGGGGGGGGGGGGGDAAAAAAAAAAAAAA
GGGGGGGGGGGGGGGGGGGGGGGGGGGGGGGGGGDDAAAAAAAAAAAAAA
GGGGGGGGGGGGGGGGGGGGGGGGGGGGGGGGGDAAAAAAAAAAAAAAAA
GGGGGGGGGGGGGGGGGGGGJJGGGGGGGGGGGGDAAAAAAAAAAAAAAA
GGGGGGGGGGGGGGGGGGGGGJGGGGGGGGGGGGDAAAAAAAAAAAAAAA
GGGGGGGGGGGGGGGGGGGGGGGGGGGGGGGGGGDAAAAAAAAAAAAAAA
GGGGGGGGGGGGGGGGGGGGGGGGGGGGGGGGGGDAAAAAAAAAAAAAAA
GGGGGGGGGGGGGGGGGGGGGGGGGGGGGGGGGGAAAAAAAAAAAAAAAA
GGGGGGGGGGGGGGGGGGGGGGGGGGDDGDDDDDAAAAAAAAAAAAAAAA
GGGGGGGGGGGGGGGGGGGGGGGGGGGGGDDDDDAAAAAAAAAAAAAAAA
GGGGGGGGGGGGJGGGGGGGGGGGGGGGDDAAAAAAAAAAAAAAAAAAAA
GGGGGGGGJGGGJJGGGGGGGGGGGGGDDDAAAAAAAAAAAAAAAAAAAA
GGGGGGGGGGGGJJGGGGGGGGGGGGGDDDAAAAAAAAAAAAAAAAAAAA
GGGGGGGGGGGGJJJJJJGGGGGGGGGDDDAAAAAAAAAAAAAAAAAAAA
GGGGGGGGGGGGJJJJJJGGGGGDDDDDADAAAAAAAAAAAAAAAAAAAA
GGGGGGGGGGGGJJJJJJGGGGDDDDDDADDAAAAAAAAAAAAAAAAAAA
GGGGGGGGGGGGGGJJJJGGGGGGDDDDDDDDAAAAAAAAAAAAAAAAAA
JGGGGGGGGJGJGGGJJJJJGGGGDDDDDDDDDDAAAAADAAAAAAAAAA
JJGGGGGGGGGJJJGJJJJJJGGGGDDDDDGGGGDAAAADDAAAAAAAAA
JJJJJGGGGGGJJJJJJJJJJJGGGDGGGGGGGGDGDDDGGDAAAADAAA
JJJJGGGGGGGJJJJJJJJJJJGGGGGGGGGGGGGGGGGGGGGGDDDDAA
JJJJJGGGGGGJJJJJJJJJJJJGGGGGGGGGGGGGGGGGGGGGGGGDAD
JJJJJJGGGJJJJJJJJJJJJJJJGGGGGGGGGGGGGGGGGGGGGGGGGG
JJJJJJGJGJJJJJJJJJJJJJJJGGGGGGGGGGGGGGGGJGGGGGGGGG
JJJJJJGGGJJJJJJJJJJJJJGGJGGGGGGGGGGGGGGJJJJGGGGGGG
JJJJJGGGGGJJJJJJJJJJJGGGGGGGGGGGGGJGGGJJJJJJJJJJJJ
JJJJJGGGGJJJJJJJJJJJJGGGGGGGGGGGGGJJJJJJJJJJJJJJJJ
JJJJJJJJJJJJMJJJMJJJJGGJJGGGGGGGGJJJJJJJJJJJJJJJJJ
JJJJJJJMJMMMMMMMJJJJJJJJJJJGGGGGGJJJJJJJJJJJJJJJJJ
JJJJJJJMMMMPPMMMJJJJJJJJJJJJGGGGGJJJJJJJJJJJJJJJJJ
JJMMJJMMMPPMMMMMMMMJJJJJJJJJJJJGJJJJJJJJJJJJJJGJJG
MJMMMJMMMMMMMMMMMMJJJJJJJJJJJJJJJJJJJJJJJJJJJJGGGG
MJMMMMPPMPMMPMMPMMMJJJJJJJJJJJJJJJJJJJJJJJJJJJGGGG
MMJMMPPMMPPPPMMPMJJJJJJJJJMMJJJJJJJJJJJJJJJJJJGGGG
MMMMPPPPPPPPPPPPMMMMJJJJJMMMJJJJJJJJJJJJJMMJJJGGGG
PMMPPPPPPPPPPPPPMMPMJMMJMMMMMJJJJJJJJJMMJMJJJJGGGG
PMMPPPPPPPPPPPPPPPPPMMMMMMMMJJJJJJJJJJMMJJJJJJJGGG
MPMPMPPPPPPPPPPPPPMMMPMMJMMMJJJJJJJJJJMJMJJJJJJGGG
MJJPPPPPPPPPPPPPPPPPPMMMMMMJJJJJJJJJJJMMJJJJJJJJGG
JMPPPPPPPPPPPPPPPPPPPMJMMJJJJJJJJJJJJJJJMJMJJJJJJG
MPMPPPPPPPPPPPPPPPPPPMMMMJJJJJJJJJJJJMMJMMMMJJJJGG
MPMMPPPPPPPPPPPPPPPPPMMMMJJJJJJJJJJJJMMMMMMMMJJJJG
JMPMPPPPPPMPPPPPPPPPPPMMMJJJJJJJJJJJMMMMMMMMMJJJJG
JMMMPPPPPPPPPPPPPPPPMMMJMJJJJJJJJJJJMMMMMMMMMJJJJG
JMMMPPPPMPPPPPPPPPPPMPMMMMMJJJJJJJJMMMJMMMJJJJJJJJ
JJJMMMJMMMMMPMPPPPPPPPPMMMMJJJJJJJJMMMJJJMJJJJJJGG
JJJMJMJMJMMMMPMPPPPPPPMMJMJJJJJJJJJMMMMMJJJJJJJJJG
MMJJJMJJJJMMPPPMPPPMPMMJJJJJJJJJJJJMJJJJJJJJJJJJJJ
MMJMJJJJJJMPMPMPPPPPPMMJJJJJJJJJJJJJMJJJJJJJJJJJJJ
MMMMMJJJJJMJMPMMPMMPMMMJJJJGJJJJJJJJJJJJJJJJJJJJJJ
