AAADGGGJGGGJJGGGGGGGGGGGGDDDAAAAAAAAAAAAAAAAAAAAAA
AAADGGGGGGGJGGGGGGGGGGGGGDDDAAAAAAAAAAAAAAAAAAAAAA
ADDGGGGGGGGGGGGGGGGGGGGDDDDDAAAAAAAAAAAAAAAAAAAAAA
DGGGGGGGGGGGGGJJGGGGGGDDGGDDAAAAAAAAAAAAAAAAAAAAAA
GGGGGGGGGJJJJJJGGGGGGGGGGGGDAAAAAAAAAAAAAAAAAAAAAA
GGGGGGGGGGJJJJJJJGGGGGDDGGDAAAAAAAAAAAAAAAAAAAAAAA
GGGGGGGGJJJJJJJJGGGGGGGDDDDAAAAAAAAAAAAAAAAAAAAAAA
JGGGGGGJJJJJJJJJJGGGGGGGDGDDAAAAAAAAAAAAAAAAAAAAAA
GGGGGGGJJJJJJJJJGGGGGGGGGGDDAAAAAAAAAAAAAAAAAAAAAA
GGGGGGJJJJJJJJJJGGGGGGGGGGDDAAAAAAAAAAAAAAAAAAAAAA
GGGGGJJJJJJJJJJJGGGGGGGGGGGDAAAAAAAAAAAAAAAAAAAAAA
GGGGGJJJJJJJJJJJJJJJGGGGGGGGDDAAAAAAAAAAAAAAAAAAAA
GGGGGGJJJJJJJJJJJJJGGGGGGGGGDAAAAAAAAAAAAAAAAAAAAA
JGGGGJJJJJJJJJJJJJJGGGGGGGGDAAAAAAAAAAAAAAAAAAAAAA
JJJJJJJJJJJJJJJJJJJGGGGGDGGDAAAAAAAAAAAAAAAAAAAAAA
JJJJJJJJJJJJJJJJGJJGGGGDDDDAAAAAAAAAAAAAAAAAAAAAAA
JJJJJJJJJJJJJJJGGJJJGGGGDDDAAAAAAAAAAAAAAAAAAAAAAA
JJJJJJJJJJJJJJJGGGJGGGGGGGGDAAAAAAAAAAAAAAAAAAAAAA
JJJJJJJJJJJJJJJJGGGGGGGGGGGDDDAADAAAAAAAAAAAAAAAAA
JJJJJJJJJJJJJJJGGGGGGGGGGGGGGDDADDDAAAAAAAAAAAAAAA
JJJJJJJJJJJJJJJJGGGGGGGGGGGGGDDAAAAAAAAAAAAAAAAAAA
JJJJJJJJJJJJJJJJGGGGGGGGGGGGGDDAAAAAAAAAAAAAAAAAAA
JJJJJJJJJJJJJJJGGGGGGGGGGGGGDDDAAAAAAAAAAAAAAAAAAD
JJJJJJJJJJJJJJJJGGGGGGGGGGGGGDAAAAAAAAAAAAAAAAAAAD
JJJJJJJJJJJJJJJJJJJGGGGGGGGGGDAAAAAAAAAAAAAAAAAAAD
JJJJJJJJJJMMMJJJJJJJGGGGGGGGGDAAAAAAAAAAAAAAAAAAAD
JJJJJJJJJMMMMMJJJJJJJGGGGGGGGGAAAAAAAAAAAAAAAAAADG
MJJJJJJJJJMMMMJJJJJJJJGGGGGGGGAAAAAAAAAAAAAAAAAADG
MMMJJJJJJJMMMMJJJJJJJJGGGGGGGDAAAAAAAAAAAAAAAAAADG
MMMMMMMMMMMMMJJJJJJJJJGGGGGGGDAAAAAAAAAAAAAAAAAADG
MMMMMMMMMMMMMJJJJJJJJJJJJGGGGDAAAAAAAAAAAAAAAAAAAD
MMMMMMMMMMMMMJJJJJJJJJJGGGGGGDAAAAAAAAAAAAAAAAAAAD
MMMMMMMMMMMMJJJJJJJJJJJJGGGGDAAAAAAAAAAAAAAAAAAAAD
MMMMMMMMJMMMJJJJJJJJJJGGGGGGDAAAAAAAAAAAAAAAAAAAAA
MMMMMMJMJMJJMJJJJJJJGGGGGGGDAAAAAAAAAAAAAAAAAAAAAA
JMMMJJMMMJMMJJMJJJJJJGGGGGGGDAAAAAAAAAAAAAAAAAAAAA
MMJMMMPMMMMMJJMMJJJJGGGGGGGGDDDAAAAAAAAAAAAAAAAAAA
MJJMMPPPPPMMJMMMJJJJJGGGGGGGGDDAAAAAAAAAAAAAAAAAAA
JJMPPPPMMMMMMMMMJJJJJJGGGGGGGGDAAAAAAAAAAAAAAAAAAA
JMMPPPPMMMMMMMJMJJJJJJJGGGGGGGGAAAAAAAAAAAAAAAAAAA
MMMPPPPMMJMMJJJJJJJJJJJJGGGGGGGDAAAAAAAAAAADDDADAA
PPMMPPPMMMMJMJJJJJJJJJJJJJGGJGGAAAAAAAAAAADDDGDDDD
MMPMPPPPMMMJMJJMJJJJJJJJJJJJJGGGDAAAAAAAADDGGGGGGG
MPPPPPPMMMMJJJMMJJJMJJJJJJJJJGGGGDAAAAAAADDDDGGGGG
PPPPPPPPMJMJMMMMMMMMJJJJJJJJJJJGGGGAAAAAAADDGGGGGG
MPPPPPPPPMPPJMPMMMMMJJJJJJJJJJJGGGGDAAAAAAADDDDDGG
PPPPPPPPPPPPPPPPMMJJJJJJJJJJJGGGGGGDAAAAAAADDDDDDG
PPPPPPPPPMPPPPPPPMJJMJJJJJJJJGJGGGGDAAAAAAAAAAADDG
PPPPPPPPPPPPPPPMPMMJMJJJJJJJJJJGGGGDAAAAAAAAAAADDG
PPPPPPPPPPPPPPPPMPMMMJJJJJJJJJJJGGGGAAAAAAAAAADDDG
