GGGGGGGGGGGGGGGGGJJJJJJJJJJJJJJJJJJJJJJJJJJJJJJJJJ
GGGGGGGGGGGGGGGGGJJJJJJJJJJJJJJJJJJJJJJJJJJJJJJJJJ
GGGGGGGGGGGGGGGGGGGJJJJJJJGJJJJJJJJJJJJJJJJJJJJJJJ
GGGGGGGGGGGGGGGGGGGGJGGGGGGGGGGJJJJJJJJJJJJJJJJJJJ
GGGGGGGGGGGGGGGGGGGGGGGGGGGGGGGGJJJJJJJJJJJJJJJJJJ
GGGGGGGGGGGGGGGGGGGGGGGGGGGGGGGGGGGJJJJJJJJJJJJJJJ
GGGGGGGGGGGGGGGGGGGGGGGGGGGGGGGGGGGGGJJJJJJJJJJJJJ
GGGGGGGGGGGGGGGGGGGGGGGGGGGGGGGGGGGGGGJJJJJJJJJJJJ
GGGGGGGGGGGGGGGGGGGGGGGGGGGGGGGGGGGGGGGJJJJJJJJJJJ
GGGGGGGGGGGGGGGGGGGGGGGGGGGGGGGGGGGGGGGGJGJJJJJJJJ
GGGGGGGGGGGGGGGGGGGGGGGGGGGGGGGGGGGGGGGGGGJGGJJJJJ
GGGGGGGGGGGGGGGGGGGGGGGGGGGGGGGGGGGGGGGGGGGGGJJJJJ
GGGGGGGGGGGGGGGGGGGGGGGGGGGGGGGGGGGGGGGGGGGGGGJJJJ
GGGGGGGGGGGGGGGGGGGGGGGGGGGGGGGGGGGGGGGGGGGGGGGJJJ
GGGGGGGGGGGGGGGGGGGGGGGGGGGGGGGGGGGGGGGGGGGGGGGGJJ
GGGGGGGGGGGGGGGGGGGGGGGGGGGGGGGGGGGGGGGGGGGGGGGJJJ
GGGGGGGGGGGGGGGGGGGGGGGGGGGGGGGGGGGGGGGGGGGGGGGJJJ
GGGGGGGGGGGGGGGGGGGGGGGGGGGGGGGGGGGGGGGGGGGGGGJJJJ
GGGGGGGGGGGGGGGGGGGGGGGGGGGGGGGGGGGGGGGGGGGGGJJJJJ
GGGGGGGGGGGGGGGGGGGGGGGGGGGGGGGGGGGGGGGGGGGGJJJJJJ
GGGGGGGGGGGGGGGGGGGGGGGGGGGGGGGGGGGGGGGGGGGGJJJJJJ
GGGGGGGGGGGGGGGGGGGGGGGGGGGGGGGGGGGGGGGGGGGGGJJJJJ
GGGGGGGGGGGGGGGGGGGGGGGGGGGGGGGGGGGGGGGGGGGGGGJJJJ
JGGGGGGGGGGGGGGGGGGGGGGGGGGGGGGGGGGGGGGGGGGGGGJJJJ
JJJGGGGGGGGGGGGGGGGGGGGGGGGGGGGGGGGGGGGGGGGGGGJJJJ
JJJJGGGGGGGGGGGGGGGGGGGGGGGGGGGGGGGGGGGGGGGGGGJJJJ
JJJJJGGGGGGGGGGGGGGGGGGGGGGGGGGGGGGGGGGGGGGGGGJJJJ
JJJJJJJJGGGGGGGGGGGGGGGGGGGGGGGGGGGGGGGGGGGGGGJJJJ
JJJJJJJJJGGGGGGGGGGGGGGGGGGGGGGGGGGGGGGGGGGGGGJJJJ
JJJJJJJJJJGGGGGGGGGGGGGGGGGGGGGGGGGGGGGGGGGGGGGJJJ
JJJJJJJJJJJGGGGGGGGGGGGGGGGGGGGGGGGGGGGGGGGGGGGGJJ
JJJJJJJJJJJJGGGGGGGGGGGGGGGGGGGGGGGGGGGGGGGGGGGGJJ
JJJJJJJJJJJJGGGGGGGGGGGGGGGGGGGGGGGGGGGGGGGGGGGGJJ
JJJJJJJJJJJJJGGGGGGGGGGGGGGGGGGGGGGGGGGGGGGGGGGGGJ
JJJJJJJJJJJJJJGGGGGGGGGGGGGGGGGGGGGGGGGGGGGGGGGGJJ
JJJJJJJJJJJJJJJGGGGGGGGGGGGGGGGGGGGGGGGGGGGGGGJJJJ
JJJJJJJJJJJJJJJGGGGGGGGGGGGGGGGGGGGGGGGGGGGGGGJJJJ
JJJJJJJJJJJJJJJGGGGGGGGGGGGGGGGGGGGGGGGGGGGGGGGJJJ
JJJJMMMJJJJJJJJJGGGGGGGGGGGGGGGGGGGGGGGGGGGGGGGJJJ
JJJMMMMJJJJJJJJJGGGGGGGGGGGGGGGGGGGGGGGGGGGGGGJJJJ
JJMMMMMMJJJJJJJJGGGGGGGGGGGGGGGGGGGGGGGGGGGGGGJJJJ
MJMMMMMMJJJJJJJJGGGGGGGGGGGGGGGGGGGGGGGGGGGGJJJJJJ
MMMPMMMMMJJJJJJJGGGGGGGGGGGGGGGGGGGGGGGGGGJJJJJJJJ
MMMPPMMMMJJJJJJJJGGGGGGGGGGGGGGGGGGGGGGGJJJJJJJJJJ
MPPPPPMMMJJJJJJJJGGGGGGGGGGGGGGGGGGGGGJJJJJJJJJJJJ
PPPPPPPMMMJJJJJJJJJGGGGGGGGGGGGGGGGGGGJJJJJJJJJJJJ
PPPPPPMMMMJJJJJJJJJJGGGGGGGGGGGGGGGGGJJJJJJJJJJJJJ
PPPPPPMMMMMMJJJJJJJJJGGGGGGGGGGGGGGGGJGGJJGGGJJJJJ
PPPPPPPMMPMMMJJJJJJJJGGGGGGGGGGGGGGGGGGGGGGGGJJJJJ
PPPPPPPPPMMMMMMJMMJJJGGGGGGGGGGGGGGGGGGGGGGGGJJJJJ
