JJJJGGGGJGJJJGJJJJJJJJJJJJJJJJJJJJJJJJGGGGGGGGGGGG
JJJJGGGGGGGJGGGJJJJJJJJJJJGGGJJJJJJJJGGGGGGGGGGGGG
JJJJJJGJJJGJGGGGGGJJJJJJGGGGGJJJJJJJJGGGGGGGGGGGGG
JJJJJJJJGJJGGGGGGGGGGGGGGGGGGGJJJJJJGGGGGGGGGGGGGG
JJJJJJJGGGGGGGGGGGGGGGGGGGGGGGGGJGGGGGGGGGGGGGGGGG
JJJJJJJJGGGGGGGGGGGGGGGGGGGGGGGGGGGGGGGGGGGGGGGGGG
JJJJJJJJGGGGGGGGGGGGGGGGGGGGGGGGGGGGGGGGGGGGGGGGGG
JJJGGGGJGGGGGGGGGGGGGGGGGGGGGGGGGGGGGGGGGGGGGGGGGG
JJJGGGGGGGGGGGGGGGGGGGGGGGGGGGGGGGGGGGGGGGGGGGGGGG
JJGGGGGGGGGGGGGGGGGGGGGGGGGGGGGGGGGGGGGGGGGGGGGGGG
JGGGGGGGGGGGGGGGGGGGGGGGGGGGGGGGGGGGGGGGGGGGGGGGGG
JJJJJJGGGGGGGGGGGGGGGGGGGGGGGGGGGGGGGGGGGGGGGGGGGG
JJJJJGJGGGGGGGGGGGGGGGGGGGGGGGGGGGGGGGGGGGGGGGGGGG
JJJJJGGGGGGGGGGGGGGGGGGGGGGGGGGGGGGGGGGGGGGGGGGGGG
JJJJGGGGGGGGGGGGGGGGGGGGGGGGGGGGGGGGGGGGGGGGGGGGGG
JJJJJJGGGGGGGGGGGGGGGGGGGGGGGGGGGGGGGGGGGGGGGGGGGG
JJJJJJGGGGGGGGGGGGGGGGGGGGGGGGGGGGGGGGGGGGGGGGGGGG
JJJJJJJJJGGGGGGGGGGGGGGGGGGGGGGGGGGGGGGGGGGGGGGGGG
JJJJJJJJJGGGGGGGGGGGGGGGGGGGGGGGGGGGGGGGGGGGGGGGGG
JJJJJJJJJGGGGGGGGGGGGGGGGGGGGGGGGGGGGGGGGGGGGGGGJJ
JJJJJJJJJGGGGGGGGGGGGGGGGGGGGGGGGGGGGGGGGGGGGGGGJJ
JJJJJJGGGGGGGGGGGGGGGGGGGGGGGGGGGGGGGGGGGGGGGGGJJJ
JJJJJJGGGGGGGGGGGGGGGGGGGGGGGGGGGGGGGGGGGGGGJJJJJJ
JJJJJGGGGGGGGGGGGGGGGGGGGGGGGGGGGGGGGGGGGGGGJJJJJJ
JJJJGGGGGGGGGGGGGGGGGGGGGGGGGGGGGGGGGGGGGGGJJJJJJJ
JJJJJGGGGGGGGGGGGGGGGGGGGGGGGGGGGGGGGGGGGGGGJJJJJJ
JJJJJGGGGGGGGGGGGGGGGGGGGGGGGGGGGGGGGGGGGGGJJJJJJJ
JJJJJGGGGGGGGGGGGGGGGGGGGGGGGGGGGGGGGGGGGGJJJJJJJJ
JJJGGGGGGGGGGGGGGGGGGGGGGGGGGGGGGGGGGGGGGGJJJJJJMM
JJJGGGGGGGGGGGGGGGGGGGGGGGGGGGGGGGGGGGGGGGJJJJJJJM
JJJGGGGGGGGGGGGGGGGGGGGGGGGGGGGGGGGGGGGGJJJJJJJJJJ
JJJJGGGGGGGGGGGGGGGGGGGGGGGGGGGGGGGGGGGJJJJJJJJJJJ
JJJGGGGGGGGGGGGGGGGGGGGGGGGGGGGGGGGGGJJJJJJJJJJMJM
JJJGGGGGGGGGGGGGGGGGGGGGGGGGGGGGGGJJJJJJJJJJJJJJMM
JJJJJJGGGGGGGGGGGGGGGGGGGGGGGGGGJJJJJJJJJJJJJJJJJM
JJJJGGJGGGGGGGGGGGGGGGGGGGGGGGJGJJJJJJJJJJJJJJJJJM
JJJJJJJGGGGGGGGGGGGGGGGGGGGGGGJJJJJJJMJJJJJJJJJJJJ
JJJJJJJGGGGGGGGGGGGGGGGGGGGGGGJJJJJMMMMMJJJMMMMMJJ
JJJJJJGGGGGGGGGGGGGGGGGGGGGGGGJJJJMMMMMMMJJMMMJJJJ
JJJJJJJGGGGGGGGGGGGGGGGGGGGGGGJJJJMMMMMMMJMMMMMMMM
JJJJJJJJGGGJJJGGGGGGGGGGGGGGGJJJJJJMMMMMMMMMMMMMJM
JJJJJJJJJJJJJJGGGGGGGGGGGGGGJJJJJMMMMMMMMMMMPPMPMM
JJJJJJJJJJJJJJJJGGGGGGGGGGGGJJJJJMMMMPPPPPMPPPPMJM
JJJJJJJJJJJJJJJJGGGGGGGGGGGJJJJJJMMMMMPPPPPPPPPMMJ
JJJJJJJJJJJJJJJJGGGGGGGGGJJJJJJJMMMPMMPPPMPPPMMMMM
JJJJJJJJJJJJJJJJGGGGGGGGJJJJJMJJJJJMMMMPMMMPPMMMMM
JJJJJJJJJJJJJJJJJJJGGJJJJJJJJMJJJJJMMMMMMMMMMMMMPP
JJJJJJJJJJJJJJJJJJJJJJJJJJJJJJJJMJJJMMMMMMMMMJMMPP
JJJJJJJJJJJJJJJJJJJJJJJJJJJJJJJJMJMMJJJMMMMMMMMPPM
JJJJJJJJJMMMMJJJJJJJJJJJJJJJJJJJJMMMMMJJJMJMJJMMMM
