MMMMMMMPPPPPPMMMMMMMJJJJJJJJJJJJGGGGDAAAAAAAAAAAAA
PPPMPPPPPPPPMMMMMMMMJJJJJJJJJJJJGGGGAAAAAAAAAAAAAA
PPPPPPPPPPPPMMMMMMJJJJJJJJJJJJGGGGGAAAAAAAAAAAAAAA
PPPPPPMPPPPPMMMMMJJJJJJJJJJJGGGGGGDAAAAAAAAAAAAAAA
PPPPPPPMPPMMMMMMJJJJJJJJJJJJGGGGDAAAAAAAAAAAAAAAAA
PPPPPPMPMPMMMMMJJJJJJJJJJJJJGGGGDAAAAAAAAAAAAAAAAA
PPPPPPMPMMPMMMMJJJJJJJJJJJJJGGGGDAAAAAAAAAAAAAAADD
PPMPMPMMMMMPMMMJJJJJJJJJJJJGGGGGDAAAAAAAAAAAAAAADD
PPPMMMPMMMMMMMJJJJJJJJJJJJJGGGGGDAAAAAAAAAAAAAAGGG
PPPMMMMMMMJMMMJJJJJJJJJJJJJJGGGGGAAAAAAAAAAAAADGGG
MMMMMJMMMMJMMMMJJJJJJJJJJJJGGGGGDAAAAAAAAAAAAADGGG
MMMMMMMJMJJMMMJJJJJJJJJJJJJGGGGGDAAAAAAAAAAAAAGGGG
MMMMMMMMMJJMMMMJJJJJJJJJJJGGGGGGAAAAAAAAAAAAADGGGG
JJMMMMMMJJJJJMJJJJJJJJJJGGGGGGGGDAAAAAAAAAAAADGGGG
JJJJMMJJJJJJJJJJJJJJJJJGGGGGGGGGAAAAAAAAAAAAAGGGGG
JJJJMJJJJJJJJJJJJJJJJGGGGGGGGGGGAAAAAAAAAAAADDGGGG
JJJJJJJJJJJJJJJJJJJJJGGGGGGGGGGDAAAAAAAAAADDDGGGGG
JJJJJJJJJJJJJJJJJJJJJGGGGDDDDDAAAAAAAAAAAAADGGGGGG
JJJJJJJJJJJJJJJJJJGJGGGGGDAAAAAAAAAAAAAAADDDDGGGGG
JJJJJJJJJJJJJJJJGGGGGGGGGDDAAAAAAAAAAAAAADDGGGGGGG
JJJJJJJJJJJJJJJJJJJGGGGGGGAAAAAAAAAAAAAAADGGGGGGGG
JJJJJJJJJJJJJJJJJJJJJJGGGGDAAAAAAAAAAAAAADDGGGGGGG
JJJJJJJJJJJJJJJJJJJJJJJGGGDAAAAAAAAAAAAAADDGGGGGGG
JJJJJJJJJJJJJJJJJJJJJJGGGDAAAAAAAAAAAAAAADDGGGGGGJ
JJJJJJJJJJJJJJJJJJJJJJGGGDAAAAAAAAAAAAAAADGGGGGJJJ
GGJJJJJJJJJJJJJJJJJJJJGGGDDAAAAAAAAAAAAAADGGGGJJJJ
GGJJJJJJJJJJJJJJJJJJJJJGGGGDAAAAAAAAAAAAAADGGGJJJJ
GGGJJJJJJJJJJJJJJJJJJJJJGGGGAAAAAAAAAAAAAADGGGJJJJ
GGJJJJJJJJJJJJJJJMJJJJJJJGGGGAAAAAAAAAAAAADGGGJJJJ
GGGJJJJJJMMMMMJJJMMJJJJJJJJGGDAAAAAAAAAAAADGGJJJJJ
GGJJJJJJMMMMMMMMJJJJJJJJJJJGGGAAAAAAAAAAAAAGGJJJJJ
GGJJJJJJMMMMMMMMJJJJJJJJJJJGGDDAAAAAAAAAAAAGGGJJJJ
GGJJJJJJJMJMMMMMJJJJJJJJJJJGGGDAAAAAAAAAAAAGGGGJJJ
GGGGJJJJJJJMMMMJJJJJJJJJJJJGGGGGDAAAAADAADGGGGGGGJ
GGGGGGJJJJJJMMJMJJJJJJJJJJJGGGGGGGAAADDDDGGGGGGGJJ
GGJGGJJJJJJJJMMMMJJJJJJJJJJGGGGGGGAAADGGGGGGGGGGGJ
GGGGGGJJJJJJMMMJJJJJJJJJJJJJGGDDGDDAGGGGGGGGGGGGGG
JGGGGJJJJJJJMMMMJJJJJJJJJJJGGGGDDDDGGGGDDDGGGGGGGG
JJJGJJJJJJMMMMMMJMJJJJJJJJJJGGGGGDGGGGDDDDGGGGGGGG
JJJJJJJJJMMMMMMMMMJJJJMJJJJJJGGGGGGGGGGDDDDGGGGGGG
JJJJJJJJMMMMMMMMMMJJJJJJJJJJJGGGGGGGGGDDDDDDGGGGGG
JJJJJJJMMMMPMMMMMMMMMJJMMJJJJGGGGGGGGGDDDDDDGGGGGG
JJJJJJJMMMMMMMMMMMMMMMJJJMJJJJGGGGGGGGGDDDDGGGGGGG
JJJJJJMMMMMMMMMJJMMMMMJMJJJJJJGGGGGGGGGGDDDGGGGGGJ
JJJJMMJMMMMMMMMMMMMMMMMMMJJJJJGGGGGGGGGGDDDGGGGGGJ
JJJJJJJJMMMMMMMMMMMMMJJMJJJJJGGGGGGGGGGGDDDDGGGGGJ
JJJJJJJJJJMMMMMMMMJMMMJJJJJJJJJGGGGGGGGGGDDDGGGGGG
JJJJJJJJJJJMMMMMMMJJJJJJJJJJJGJJGGJJGGGGGDDGGGGGGJ
JJJJJJJJJJJJMMMMMMJJJJJJJJJJJJJJJJJJGGGGGGDGGGGGGG
GGGGGGJJJJJJMMMMMJJJJJJJJJJJJJJJJGJGGGGGGDGGGGGGGG
