JGGGGGGGGGGGGGGGGGGGGGGGGGGGGGGGGGGGGGGGGGGGGGGGGG
JGGGGGGGGGGGGGGGGGGGGGGGGGGGGGGGGGGGGGGGGGGGGGGGGG
GGGGGGGGGGGGGGGGGGGGGGGGGGGGGGGGGGGGGGGGGGGGGGGGGG
GGGGGGGGGGGGGGGGGGGGGGGGGGGGGGGGGGGGGGGGGGGGGGGGGG
GGGGGGGGGGGGGGGGGGGGGGGGGGGGGGGGGGGGGGGGGGGGGGGGGG
GGGGGGGGGGGGGGGGGGGGGGGGGGGGGGGGGGGGGGGGGGGGGGGGGG
GGGGGGGGGGGGGGGGGGGGGGGGGGGGGGGGGGGGGGGGGGGGGGGGGG
GGGGGGGGGGGGGGGGGGGGGGGGGGGGGGGGGGGGGGGGGGGGGGGGGG
GGGGGGGGGGGGGGGGGGGGGGGGGGGGGGGGGGGGGGGGGGGGGGGGGG
JGGGGGGGGGGGGGGGGGGGGGGGGGGGGGGGGGGGGGGGGGGGGGGGGG
GGGGGGGGGGGGGGGGGGGGGGGGGGGGGGGGGGGGGGGGGGGGGGGGGG
GGGGGGGGGGGGGGGGGGGGGGGGGGGGGGGGGGGGGGGGGGGGGGGGGG
GGGGGGGGGGGGGGGGGGGGGGGGGGGGGGGGGGGGGGGGGGGGGGGGGG
GGGGGGGGGGGGGGGGGGGGGGGGGGGGGGGGGGGGGGGGGGGGGGJGGJ
GGGGGGGGGGGGGGGGGGGGGGGGGGGGGGGGGGGGGGGGGGGGGGJJJJ
GGGGGGGGGGGGGGGGGGGGGGGGGGGGGGGGGGGGGGGGGGGGJJJJJJ
GGGGGGGGGGGGGGGGGGGGGGGGGGGGGGGGGGGGGGGGGGGJJJJJJJ
GGGGGGGGGGGGGGGGGGGGGGGGGGGGGGGGGGGGGGGGGGJJJJJJJJ
GGGGGGGGGGGGGGGGGGGGGGGGGGGGGGGGGGGGGGGGGJJJJJJJJJ
GGGGGGGGGGGGGGGGGGGGGGGGGGGGGGGGGGGGGGGGGJJJJJJJJJ
GGGGGGGGGGGGGGGGGGGGGGGGGGGGGGGGGGGGGGGGGGGJJJJJJJ
GGGGGGGGGGGGGGGGGGGGGGGGGGGGGGGGGGGGGGGGGJGGGJJJJJ
GGGGGGGGGGGGGGGGGGGGGGGGGJJJGJGGGGGGGGGGGGJJGGJJJJ
GGGGGGGGGGGGGGGGGGGGGGGGGJJJJJJJGGGGGGGGGJJJJJJJJJ
GGGGGGGGGGGGGGGGGGGGGGGGGJJJJJJJGGGGGGGGGJJJJJJJJJ
GGGGGGGGGGGGGGGGGGGGGGGGGJJJJJJJGJJGGGGGGJJJJJJJJJ
GGGGGGGGGGGGGGGGGGGGGGGGGJJJJJJJJJJJGGGGJGJJJJJJJJ
GGGGGGGGGGGGGGGGGGGGGGGGGJJJJJJJJJJJJGGGJJJJJJJJJJ
GGGGGGGGGGGGGGGGGGGGGGGGGJJJJJJJJJJJJJJJJJJJJJJJJJ
GGGGGGGGGGGGGGGGGGGGGGGGGJJJJJMJJJJJJJJJJJJJJJJJJJ
GGGGGGGGGGGGGGGGGGGGGGGGJJJJJMMMMMJJJJJJJJMJMJJJJJ
GGGGGGGGGGGGGGGGGGGJJGGJJJJJJJMMMMMJJJMMMJMMMMJJMJ
GGGGGGGGGGGGGGGGGGJJJJJJJJJJJJMMJMMMMMMMJJJMMMJJJJ
JJGGGGGGGGGGGJJJGGJJJJJJJJJJJJJMMMMMMMMMMMMJMMMJMM
JJGGGGGGGGGGJJJJJJJJJJJJJJJJJJJJMJMMMMMMMMMJMJJJMJ
JJJGGGGGGGGGGJJJJJJJJJJJJJJJJJJJJJMMMMMMMMMJMJMJJJ
JJGGGGGGGGGGGGGJJJJJJJJJJJJJJJJJJJMMMMMMMMJJMMMMJJ
GGGGGGGGGGGGGGGJJJJJJJJJJJJJJJJJMJMMMMMMJMMMMMMMMM
GGGGGGGGGGGGGGGJJJJJJJJJJJJJJJJJMMMPMPPPMMMJMMMMMM
GGGGGGGGGGGGGGGGJJJJJJJJJJJJJJJMMMMPPPMMJMMMMMMMMJ
GGGDDDDDGGDGGGGGGJJJJJJJJJJJJJJJMMMMMMMMMJMPMMPMPM
GGDDDDDDDDDGGGGGGJJJJJJJJJJJJJJMJMMMMMMMMMMMMPPPPM
GGDDDDDDDGDDGGGGGGJJJJJJJJJJJMMMJMJMMMMMMMMMMPPPPP
DGDDDDDDDGGGGGGGJJJJJJJJJJJJJJJJJMMJJJMMMJJMMMPPMM
DDDDDDDDGGGGGGGGJJJJJJJJJJJJJJJJMMJJJMMJMMMMMMMMMM
GDDDDDGDGGGGGGGGJJJJJJJJJJJJJMMMJMMMMMJMPPMPMMMMMM
GDDDDDGGGGGGGGJJJJJJJJJJJJJJJJMMMMMMMPMJMMMPMJMMMM
GDDDDDGGGGGJJJJJJJJJJJJJJJJJMMJMMMPPPPPPMPMPMMPMMM
DDDDDDGGGJJJJJJJJJJJJJJJJJJJMMMMMMPMPPPPPPJMPPPPMM
DDDDDDGGGJGGJJJJJJJJJJJJMMJMMPMMPPPPPMMMMMMPMPPPMP
