JJJJJJJJJJJJJJJJJJJJJJGGGGAAAAAAAAAAAAAAAAAAAAAAAA
JJJJJJJJJJJJJJJJJJJJJJGGGGAAAAAAAAAAAAAAAAAAAAAAAA
JJJJJJJJJJJJJJJJJJJJJJJGGGAAAAAAAAAAAAAAAAAAAAAAAA
JJJJJJJJJJJJJJJJJJJJJJJGGGAAAAAAAAAAAAAAAAAAAAAAAA
JJJJJJJJJJJJJJJJJJJJJJJGGGDAAAAAAAAAAAAAAAAAAAAAAA
MMJJJJJMJJJMJMMMJJJJJJJJGGGDDAAAAAAAAAAAAAAAAAAAAA
MMMJJMMMMJMJJMMMMJJJJJJJJGGGGDDAAAAAAAAAAAAAAAAAAA
MMMMMMMMMMMJJMMMMJJJJJJJJGGGGGGAAAAAAAAAAAAAAAAAAA
MMMMMMMMMMMMMMMMMMJJJJJJJJJGGGGDAAAAAAAAAAAAAAAAAA
MMMMMMMMMMMMMMMMJJJJJJJJJJJGGGDAAAAAAAAAAAAAAAAAAA
MMMMMMMMMMMMMMMMMJJJJJJJJJJGGGDAAAAAAAAAAAAAAAAAAA
PPMMMMMMMMMMMMMMMMJJJJJJJJJGGGDDAAAAAAAAAAAAAAAAAA
PPMMMMMMMMMMMMMMMJJJJJJJJJJGGGDDAAAAAAAAAAAAAAAAAA
PPMMMMMMMMMMMJJMMMJJJJJJJJJGGGDDADAAAAAAAAAAAAAAAA
PMMMJJMMMMMMMJJJJJJJJJJJJJJGGGGDDAAAAAAAAAAAAAAAAA
MMMMJJJMMMMJJJJJJJJJJJJJJJJGGGGDDDAAAAAAAAAAAAAAAA
MPMMMJJJMMMJJJJJJJJJJJJJJJJJGGDGGDAAAAAAAAAAAAAAAA
PPMMJJJJMJJJJJJJJJJJJJJJJJJGGGGGGDAAAAAAAAAAAAAAAA
MMPMMMJJJJJJJJJJJJJJJJJJJJJJGGGGGGAAAAAAAAAAAAAAAA
MMMMMMJJJGJJJJJJJJJJJJJJJJJJGGGGGDAAAAAAAAAAAAAAAA
MMJMJJJJGGJJJJJJJJJJJJJJJJJJGGGGGDDAAAAAAAAAAAAAAA
MJJJJJJJJGJJGJJJJJJJJJJJJJJGGGGGGGDDAAAAAAAAAAAAAA
MJJJJJJGGJJJJJJJJJJJJJJJJGGGGGGGGGGDDDAAAAAAAAAAAA
MJJJGGGGGGGJJJJJJJJJJJJJJGGGGGGGGGGDDDDAAAAAAAAAAA
MMJJJGGGGGGGJJJJJJJJJJJJGGGGGGGGGGGDDDDDAAAAAAAAAA
MMJJGGGGGGGJJJJJJJJJJJJJGGGGGGGGDDDDDDDDAAAAAAAAAA
JJJJGGGGGGJJJJJJJJJJJGGGGGGGGGGGDDDDDDAAAAAAAAAAAA
JJJJGGGGGGJJJJJJJJJJJGGGGGGGDDGDDDDDDAAAAAAAAAAAAA
JJJJJGGGGJJJGJJJJJJJJGGGGGGGDAAADDDDAAAAAAAAAAAAAA
JJJJJGJGGGGJJJJJJJJJJGGGGGGGDAAAAAAAAAAAAADDDAAAAA
JJJJJJGJJGJJJJJJJJGGGGGGGGGGAAAAAAAAAAAADDGGDAADDA
JJJJJJGJGGJJJJJJJJGGGGGGGGDAAAAAAAAAAAAADGGGGGDGGD
JJJJJJJJJJJJJJJJJGGGGGGGGDAAAAAAAAAAAAAADGGGGGGGGG
JJJJGJJJJJJJJJJJJGGGGGGGDAAAAAAAAAAAAAADDGGGGGGGGG
JJJJJJJJJJJJJJJJJGGGGGGDDAAAAAAAAAAAAAADDGGGGGGGGG
JJJJJJJJJJJJJJJJJGGGGGGGDAAAAAAAAAAAADDDDGGGGGGGGG
JJJJJJJJGJJJJJJJJJGGGGGGDDAAAAAAAAAADDGDGGGGGGGGGG
JJJJJJJJGGGGJJJJJJGGGGGGGGDAAAAAAAADGGGGGGGGGGGGGG
JJJJJJJGGGGGJJJJJGGGGGGGGDDAAADAAADGGGGGGGGGGGGJJJ
JJJJJJJJGGGGGGJJJJJGGGGGDDDAAADAAADGGGGGGGGGGGJJJJ
JJJJJJJJJGGGGJJJJJJGGGGGDAAAAAAAAADDDDDDGGGGGGJJJJ
JJJJJJJJJJJJGJJJJJJJGGGGDAAAAAAAAAAADDDDGGGGGGJJJJ
JGJJJJJJJJJJJJJJJJJJGGGGGAAAAAAAAAAAAADDDGGGGGJJJJ
GGJJJJJJJJJJJJJJJJJJGGGGGAAAAAAAAAAAAADDGGGGGGJJJJ
GGGJJJJJJJJJJJJJJJJJGGGGGAAAAAAAAAAAAADDGGGGGGJJJJ
GGGGGJJJJJJJJJJJJJJJGGGGGAAAAAAAAAAAAAADGGGGGGGJJJ
GGJJJJJJJJJJJJJJJJJGGGGGDAAAAAAAAAAAAADDGGGGGGJJJJ
GJJJJJJJJJJJJJJJJGGGGGGGDAAAAAAAAAAADDDDGGGGGJJJJJ
GJJJJJJJJJJJJJJJJGGGGGGDAAAAAAAAAAAADDDDGGGGJJJJJJ
JJJJJJJJJJJJJJJJJGGGGDDDAADAAAAAAAADDDDDGGGGJJJJJJ
