GGGGGGGGGGGGGGGGGGGGGGGGJGJJJJJJJJJJJJJJJJJJJJJJJJ
GGGDDDDDDGGGGGGGGGGGGGGGGGJJJJJJJJJJJJJJJJJJJJJJJJ
GGGDAAAADDGGGGGGGGGGGGGGGGGJJGJJJJJJJJJJJJJJJJJJJJ
GDAAAAAAAADGGGGGGGGGGGGGGGGGGGJJJJJJJJJJJJJJJJJJJJ
AAAAAAAAAADGGGGGGGGGGGGGGGGGGGJJJJJJMJJJJJJJJJJJJJ
AAAAAAAAAAAADGGGGGGGGGGGGGGGGGJJJJJJJJJJJJJJJJJJJJ
AAAAAAAAAAAAADDGGGGGGGGGGGGGGJJJJJJJJJJJJJJJJJJJJJ
AAAAAAAAAAAAAAADGGGGGGGGGGGGJJJJJJJJJJJJJJJJJJJJJJ
AAAAAAAAAAAAAAAADGGGGGGGGJJJJJJJJJJJJJJJJJJJJJJJJJ
AAAAAAAAAAAAAAAAADGGGGGGGJJJJJJJJJJJJJJJJJJJJJJJJJ
AAAAAAAAAAAAAAAADDDGGGGGJJJJJJJJJJJJJJJJJJGJJJJJJJ
AAAAAAAAAAAAAAAAAAADGGGJJJJJJJJJJJJJJJJJGGGGJJJJJJ
AAAAAAAAAAAAAAAAAAAADGGGJJJJJJJJJJJJJJJJGGGJJJJJJJ
AAAAAAAAAAAAAAAAAAAAADGGJJJJJJJJJJJJJJJJGGGJJJJJJJ
AAAAAAAAAAAAAAAAAAAAADGGJJJJJJJJJJJJJJJJGGGJJJJJJJ
AAAAAAAAAAAAAAAAAAAAAGGGJJJJJJJJJJJJJJJJGGJJJJJJMM
AAAAAAAAAAAAAAAAAAAAAGGJJJJJJJJJJJJJJJJJJGJJJJMMMM
AAAAAAAAAAAAAAAAAAAADGGJJJJJJJJJJJJJJJJGGJJJJJMMMM
AAAAAAAAAAAAAAAAAAAADGGGJJJJJJJJJJJJJJJJGJJJJMMMMM
AAAAAAAAAAAAAAAAAAAADGGGGJJJJJJJJJJJJJJJJJJJJMMMMM
AAAAAAAAAAAAAAAAAAAADDGGGGGGJJJJJJJJJJJJJJJJMMMMMM
AAAAAAAAAAAAAAAAAAAAADGGGGGGGGGGJJJJJJJJJJJMMMMPPJ
DDDDDDAAAAAAAAAAAAAAAAGGGGGGGGGGGJJJJJJJJMMMMMMPMJ
GGGGGGGAAAAAAAAAAAAAAAGGGGGGGGGGGJJJJJMJMMMMMPPPMM
GGGGGGGAAAAAAAAAAAAAAADGGGGGGGGGGJJJJMMMMMMMPPPPPM
GGGGGGGDAAAAAAAAAAAAAADGGGGGGGGGJJJJJJMMMMMPPPPPMM
GGGGGDDDDAAAAAAAAAAAAADGGGGGGGGJJJJJMMMMMMPPPMMMMM
GGGGGDDDDDAAAAAAAAAAAADGGGGGGGGJJJJJMMMMMMPPPMMMMM
GGGGGGGGGDAAAAAAAAAAAADGGGGGGGGJJJJJMMMMMMMMMMMMMM
GGGGGGGGGGDAAAAAAAAAAADGGGGGGGGGJJJMMMMMMMMMMMMMMM
JGGGGGGGGGDAAAAAAAAAADDDGGGGGGGJJJJJMMMMMMMMMMMMMM
JJJJGGGGGGDAAAAAAAAAAADADGGGGGGGJJJJMMMMMMMMMMMMMM
JJJJGGGGGGDDAAAAAAAAAAAAAGGGGGGGJJJJJJMMMMMMMMMMMM
JJJJJJJJGGGDDAAAAAAAAAAADGGGGGGGJJJJJJJJMMMMMMMPMM
JJJJJJJJJGGGGGDDAAAAAAAAGGGGGGGGGJJJJJJJMMMMMMMMMM
JJJJJJJJJJGGGGGDGDDAAAAAGGGGGGGGGGJJJJJMMMMMMMMMJM
JJJJJJJJJJJGGGGGGGGDDDAADDGGGGGGGGJJJJJMMMMMMJJJMM
JJJJJJJJJJJJJJGGGGDDDDDGGGGGGGGGGJJJJJJMMMMMMJJJJJ
JJJJJJJJJJJJJGGGGDDDDGGGGGGGGGGGGGJJJJJMMMMMMJJJJJ
JJJJJJJJJJJJJJGGGDGGGGGGGGGGGGGGJJJJJJJMMMMMMJJJJJ
MJJJJMJJJJJJJJGGGGGGGGGGGGGGGGGGGJJJJJJJMMMMMMJJJJ
MMJJJMJJJJJJJGGGGGGGGGGGGGGGGGGGGGGJJJJJJMMMMMJJJJ
MMMJJJJJJJJJJGGGGGGGGGGGGGGGGGGGGGJJJJJJJMJMMJJJJJ
MMMJMJJJJJJJGGGGGGGGGGGGGGGGGGGGGGJJJJJJJJJJJJJJJJ
MMJJJJJJJJJJJGGGGGJJJGGGGGGGGGGGJJJJJJJJJJJJJMJJJJ
MMMJMJJJJJJJJJJJJJJJJGGGGGGGGGGGJJJJJJJJJJJJJJJJJJ
MMMJMMJJJJJJJJJJJJJJJGJGGGGGGGGGGJJJJJJJJJJMJJJJJJ
MMMMMMJJJJJJJJJJJJJGGGJGGGGGGGGGGJJJJJJJJJJJJJJJJJ
MMMMMMJJJJJJJJJJJJGGGGGGGGGGGGGGGGJJJJJJJJJJMJJJMJ
MMMMJJJJJJJJJJJJJJGGGGGGGGGGGGGGGGJJJJJJJJJJJJJJJJ
