AAAAAAAAAAAAAAAADGGGGJJJJJJJJJJJJJMJJJJMMMPPMMMMMJ
AAAAAAAAAAAAAAAADGGGGJJJJJJJJJJJJJJJJJJJJMMMMMMMMJ
AAAAAAAAAAAAAAAADGGGGGJGJGGGJJJJJJJJJJJJJJJMMPMMMM
AAAAAAAAAAAAAAAADDGGGGGGGGGGGJJJJJJJJJJJJJJMMMMJMJ
AAAAAAAAAAAAAADDDDGGGGGGGGGGGGJJJJJJJJJJJJJJMMMJJM
AAAAAAAAAAADDGDDDGGGGGGGGGGGGGGGJJJJJJJJJJJJMMJJMM
AAAAAAAADADGGGGGDGGGGGGGGGGGGGGGGJJJJJJJJJJJJMJJMM
AAAAAAAADDGGGGGGGGGGGGGGGGGGGGGGGGJJJJJJJJJJJMJJJJ
AAAAAAADDGGGGGGGGGGGGGGGGGGGGGGGGGGJJJJJJJJJJJJJJJ
AADDDDGGGGGGGGGGGGGGGGGGGGGDGGGGDGGGGGGGJJGJJJJJJJ
DDDGGGGGGGGGGGGGGGGGGGGGGGGDDDDDDGGGGGGGGGGJJJJJJJ
GGGGGGGGGGGGGGGGGGGGGGGGDDGGDGGDDDGGGGGGGGGGGJJJJJ
GGGGGGGGGGGGGGGGGGGGGGGGDDDDDDDDDDDDDDDAADGGGGJJJJ
GGGGJJJJJGGGGGGGGGGGGGGDDDAAAAAAAAAAADAAAAAAAGGJJJ
GGGJJJJJJJJGGGGGGGGGGGDDDAAAAAAAAAAAAAAAAAAAAGGGJJ
JGGJJJJJJJJJGGGGGGGGGGGDAAAAAAAAAAAAAAAAAAAAADGGJJ
JJJJJJJJJJJJJGGGGGGGGGGGDAAAAAAAAAAAAAAAAAAAAAAGGG
JJJJJJJJJJJJJJGGGGGGGGGGDAAAAAAAAAAAAAAAAAAAAAAGGG
MJJJJMMJJJJJJJGGGGGGGGGGDAAAAAAAAAAAAAAAAAAAAAADGG
MMMMMMMMJJJJJJJJGGGGGGDDAAAAAAAAAAAAAAAAAAAAAAAADG
MMMMMMMMJJJJJJJJJGGGGGDDAAAAAAAAAAAAAAAAAAAAAAAADG
MMMMMMMMJJJJJJJJJJGGGGGDAAAAAAAAAAAAAAAAAAAAAAAADG
MMMMMMMMJJJJJJJJJJJGGGGAAAAAAAAAAAAAAAAAAAAAAAAADG
MMMMMMJJJJJJJJJJJJGGGGGDDAAAAAAAAAAAAAAAAAAAAAADDG
MMMJJJJJJJJJJJJJJJGGGGGGDDAAAAAAAAAAAAAAAAAAAADDDG
MMMMJJJJJJJJJJJJJJJGGGGGGGDAAAAAAAAAAAAAAAAADDDDGG
MMJJJJJJJGJJJJJJJJJGGGGGGGDAAAAAAAAAAAAAAAAADGDGGG
MMMJJJGGGGJJJJJJJGGGGGGGGGGDAAAAAAAAAAAAAAAADGGGGG
MMMJJJJGGGJJJJJJJJJJGGGGGGGDDDAAAAAAAAAAAAADDGGGGG
MJMJJJJJGJJJJJJJJJJJJGGGGGGGDDDAAAAAAAAAAADADGGGGG
JMJJJJJJJJJJJJJJJJJJJJGGGGGGDDDAAADDAAAADDDDDGGGGG
JJJJJJJJJJJJJJJJJJJJJGGGGGGGGGDDDDDDDDDDDDDDGGGGGG
JMJMJJJJJJJJJJJJJJJJJGGGGGGGGGGGGGGGDDDDDGDDGGGGGG
JJJJJJJJJJJJJJJJJJJJJGGGGGGGGGGGGGGGDDDDDGDDDGGGGG
JJJJJJJJJJJJJJJJJJJJJGGGGGGGGGGGGGGGGDGGGDDDDDDDDD
JJJJJJJJJJJJJJJJJJJJJJGGGGGGGGGGGGGGGDGDDDDDDDADDD
JJGJJJJJJJJJJJJJJJJJJJGJGJGGGGGGGGGGDDDDDDDDADAADD
JJGJJJJJJJJJJJJJJJJJJJJJJJJGGGGGGGGDDDDDDDDAAAAAAA
JJJJJJJJJJJJJJJJJJJJJJJJJJJGGGGGGGGGDDDDDDAAAAAAAA
MMJJJJMJJJJJJJJJJJJJJJJJJJJJJJGGGGGGGGDDDDAAAAAAAA
MJMMMMMJJJJJJJJJJJJJJJJJJJJJJJJJGGGGGGDDDAAAAAAAAA
MMMMJMMMMJMJJJJJJJJJJJJJJJJJJJJJGGGGGGGDDAAAAAAAAA
MJJMJJJJMJMJJJJJJJJJJJJJJJJJJJJJGGGGGGDDDDAAAAAAAA
PMMMJJMMJMMJJJJJJJJJJJJJJJJJJJJJGGGGGGDDDAAAAAAAAA
MMMMMJJJMMMMJJJJJJJJJMMJJJJJJJJJGGGGGGDDDAAAAAAAAA
PMJJJJJMMMMMJJJJJJJJJMMJJJJJJJJJJGGGGGDDDAAAAAAAAA
MMMMJMJMMPPMMMMJJJJJJJMMJJJJJJJJJGGGGGDAAAAAAAAAAA
MMMMMMPPPPPMMMJJJJJMMMJMMJJJJJJJJGGGGGDAAAAAAAAAAA
PMPPMPPPPPPMMJMJJJMMMMMJJJJJJJJJGGGGGDAAAAAAAAAAAA
MPPPPPPPPPPMMMJJJJJMMMMJJJJJJJJGGGGGDAAAAAAAAAAAAA
