JJJJJJJJJJJJJMMMMMMPPPPPPPMPPPPPPPPPMMMMMJJJJJJJJJ
JJJJMJJJJJJMMMMMMMPPPPPPPMPPPPPPPPPMMMJJJJJJJJJJJJ
JJJJJMMJJJJJJJMMPMMPPMMMMPPPPPPPPPMMMJJJJJJJJJJJJJ
JJJJJMMJJJJJJJMMMPMMMJMMPPPPPPPPPPMMJJJJJJJJJJJJJJ
JJJJJJMJJJJJMJMMMPMPPMMMMPMPPPPMPPMMMJJJJJJJJJJJJJ
JJJJJJMJJJJMMMMMMMMMPMJMMPMMMPMMMPMMMJJJJJJJJJJJJJ
JJJJJMMMMMMMMMMMMMMMMMMMMMMMMMMMMPPMMJJJJJJJJJJJJJ
JJJJJMMMMMMMMMMJMMMJMJMJJJJMMMMMPPPMMJJJJJJJJJJJJJ
JJJJJJMMMMMMMMMJJMMMMMMJJJMMMMJMMMPMMJJJJJJJJJJJJJ
JJJMMJMMMMMJMJMMMMMJJMMMJJJJJJMJMMMMMMMJJJJJJJJJJJ
JJJJMMMMMMMJJJMMJMJJJMJJJJJJJMMMMMMMMMJJJJJJJJJJJG
JJJMMMMMMMMJJJJJJJMJMMJJJJJJJJMMMJJJMMJJJJJJJJJJGG
JJJJMMMMMMMJJJJJJJJJJMJMJJJJJJMMJJJJJJJJJJJJJJJJJG
JJJJMMMMMMJJJJJJJJJJJMMMMJJJJJJJJJJJJJJJJJJJJJJJGG
MJJJJJMJJJJJJJJJJJJJMJMJJJJJJJJJJJJJJJJJJJJJJJJJGG
JJJJJJJJJJJJJJJJJJJJJJJJJJJJJJJJJJJJJJJJMMJJJJJJJG
JJJJJJJJJJJJJJJJJJJJJJJJJJJJJJJJJJJJJJJMMMJJJJJJJJ
JJJJJJJJJJJJJJJJJJGJJJJJGJJJJJJJJJJJJJJJJJJJJJJJJJ
JJJJJJJJJJJJJJJJJGGGGJGGGGGGGGGJJJJJJJJJJJJJJJJJGG
JJJJJJJJJJJJJGGGGGGGGGGGGGGGGGGGGGJGGJJJJJJJJJJGGG
JJJJJJJJJJJJJGGGGGGGGGGGGGGGGGGGGGGJJJJJJJJJJJJJGG
GJJJJJJJJJJJJGGGGGGGGGGGGGGGGGGGGGGGGJJJJJJJJJJJGG
GGGJGJJJJGGGGGGGGGGGGGGGGGGGGGDGGGGJJJJJJJJJJJJJJJ
GGGGGGGGGGGGGGGGGGGGGGGGGGGGGGADGGGGGJJJJJJJJJJJJG
GGGGGGGGGGGGGGGGGGGGGGGGGGGGGDDADDGGGGGJJJJJGGGGGG
GGGGGGGGGGGGGGGGGGGGGGGGGGGGGDAAADDDGGGJJGGGGGGGGG
GGGGGGGGGGGGGGGGGGGGGGGGGGGGDAAAAAAGGGGGGGGGGGGGGG
GGGGGGGGGGGGGGGGGGGGGGGGGGGDAAAAAAADGGGGGGGGGGGGGG
GGGGGGGGGGGGGGGGGGDGGGGGGGGDAAAAAAADGGGGGGGGGGGGGG
DDGGGDDGGGGGGGGGDGDDGGGGGGGDDDAAAAGGGGGJJGGGGGGGGG
DDDDDDDGGGGGGDDGGDDDGGGGGGGDDAAAADGGGGGJJGGGGGGGGG
DDDDDDDGGGGDDDDGGGDDDDDDGGGDDAAAADGGGGGJGGGGGGGGGG
ADDDDDDDGGDDDDDGGGDGDAAAADGDAAAADDGGGGJGGGGGGGGGGG
AAADAAADDGDDDDGGGDDDDAAAAAAAAAAADGGGGJJJGGGGGGGGGG
AAAAAAAADDDDDDGDDDDDAAAAAAAAAAAADGGGGJJJGGJGGGGGGG
AAAAAAAAAADDDDDDDDDDDDAAAAAAAAAADGGGGGJGGGGJGGGGGG
AAAAAAAAAAADDDDDDAAADAAAAAAAAAADDGGGGGJGGGGGGGGGGG
AAAAAAAAAAADDDDDAAAAAAAAAAAAAAADDDGGGGGGGGGGGGJGGG
AAAAAAAAAAADDDDAAAAAAAAAAAAAADDDDDGGGGGGGGGGGGJJJJ
AAAAAAAAAAAADDAAAAAAAAAAAAAAAADDAADGGGGGGGGGGJJJJJ
ADDDAAAAAAAADDAAAAAAAAAAAAAAAAAAAAAGGGGGGGGGGJJJJJ
GGGDDAAAAAAAAAAAAAAAAAAAAAAAAAAAAAADGGGGGGGGGJJJJJ
GGGGDDAAAAAAAAAAAAAAAAAAAAAAAAAAAADDGGGGGGGGJJJJJJ
GGGGDDAAAAAAAAAAAAAAAAAAAAAAAAAAAADGGGGGGGGGJJJJJJ
GGGGGDAAAAAAAAAAAAAAAAAAAAAAAAAAADDGGGGGGGGJJJJJJJ
JJGGGGDAAAAAAAAAAAAAAAAAAAAAAAAAADGGGGGGGGGJJJJJJJ
JJJJGGGDAAAAAAAAAAAAAAAAAAAAAAAAADGGGGGGGGGJJJJJJJ
JJJJGGGGDAADAAAAAAAAAAAAAAAAAAAAAADGGGGGGGGJJJJJJJ
JJJJGGGGGDDDAAAAAAAAAAAAAAAAAAAAAADDGGGGGGGGJJJJJJ
JJJJJGGGGGDDDDAAAAAAAAAAAAAAAAAAAAADGGGGGGJJJJJJJJ
