AAAAAAADDDDGGGGGGDDDAADDDDDDGGGGGGGJJJJJJMMMMMMMMM
AAAAAAADDDDGGGGGGDDDAAADDDDDDGGGGGGJJJJJJMMMMMMMMM
AAAAAAADDGGGGGGGGGDDAAAADAADDDGGGGGJJJJJJJJMMMMMMM
DDAAAAADDGGGGGGGGGGGDDAAAAADDGGGGGJJJJJJJJMMMMMMMM
DDDAAAAADGGGGGGGGGGGDDAAAAADGGGGGGJJJJJJJJMMMMMMMM
GGDDAAAADDDDDDDDGGGGDAAAAADDGGGGGJJJJJJJJJJMMMMMMM
GGDGDAAADADDDDDDGGGDAAAAAADDGGGGGJJJJJJJJJJJMMMMMM
GGGGGDAAAAAAAADDGGGDAAAAAAADGDDGGGJJJJJJJJJMMMMMMM
GGGGGDDAAAAAADDGDDDDAAAAAAADDDGGGGGGJJJJJJJMMMMMMM
GGGGGDAAAAAAAADDDAAAAAAAAAAADDGGGGGGGGGJJJJJJMJMMM
GGGGDDDADAADDDDAAAAAAAAAAAAAADGGGGGGGGGJJJJJJJJMMM
GGGGGDDGGDDDDDDDAAAAAAAAAAAAAADGGGGGGGGJJJJJJJJJJM
GGGGGGGGGDDDDGDAAAAAAAAAAAAAAADGGGGGGGGJJJJJJJJJJM
JGGGGGGGGGGDGGDAAAAAAAAAAAAAAADGGGGGGGGJJJJJJJJJJJ
JJJGGGGGGGGGGGDAAAAAAAAAAAAAAADGGGGGGGJJGJJJJJJJJJ
JJJGGGGGGGGGGGDAAAAAAAAAAAAAAADDGGGGGGGJJJJJJJJJJJ
JJJJGGGGGGGGGGGDAAAAAAAAAAAAAAADDGGGGGJJJJJJJJJJJJ
JJJJGGGGGGGGGGGDAAAAAAAAAAAAAAAADDGGGGGGJGJJJJJJJJ
JJJJGGGGGGGGGGGGDDAAAAAAAAAAAAAAAADGGGGGGGGJJJJJJJ
JJJJJGGGGGJJGGGGGDAAAAAAAAAAAAAAAADDGGGGGGGGGJJJJJ
JJJJJJJJJJJJJJGGGGDAAAAAAAAAAAAAAAAAGDDGGGGGGGGJJJ
JJJJJJJJJJJJJJGGGGGGDDDAAAAAAAAAAAADDDAADDGGGGGGJJ
MJJJJJJJJJJJJGGGGGGGGGDDDDADAAAAAAAADDAADADDDDGGGJ
MMMJJJJJJJJJGGGGGGGGGGGGDDDDDAAAAAAAAAAAAADGDGGGGJ
MMMMJJJJJJJJGGGGGGGGGGGGGDDDAAAAAAAAAAAADDDDGGGGGJ
MMMJJJJJJJJJJGGGGGGGGGGGGDDAAAAAAAAAAAADDDDDDGGGGG
MJJJJJJJJJJJJGGGGGGGGGGGGGDAAAAAAAAAAADDDDDDGGGGGG
MMJJJJJJJJJJGGGGGGGGGGGDDDAAAAAAAAAAAADDGGGGGGGGGG
MMMMMJJJJJJJJGGGGGGGGGDDAAAAAAAAAAAAAAAGGGGGGGGGGG
MMMMMMMJJJJJJJGGGGGGGGDAAAAAAAAAAAAAAADGGGGGGGGGGG
MMMJMMMJJJJJJJGGGGGGGDDDAAAAAAAAAAAAADGGGGGGGGGGGG
MMMMMJMJJJJJJJGGGGGGGDDDAAAAAAAAAAAADDGGGGGGGGGGGG
MJJMJJJJJJJJJJJJGGGGGDDDAAAAAAAAAAAADGGGGGGGGGGGGG
MMJJJMJJJJJJJJJJGGGGGGDDAAAAAAAADDDDDGGGGGGGGGGGGG
JJMMMMMMMJJJJJJJGGGGGGDAAAAAAAAADDDDDGGGGGGGGGGGGG
JMMMMMMMJMJJJJJJGGGGGGDAAAAAAAAADDDDDDGGGGGGGGGGGG
JJMMMMMMMJMMMJJJGGGGGGGDAAAAAAAAGGDDDGGGGGGGGGGGGG
MMMMMPMMMMMMMMJJJGGGGGGGDAAAADDGGGGDDGGGGGGGGGGGGG
JMMPPPPPMMMMMJJJJJGGGGGGDADDDDGGGGGGGGGGGGGGGGGGGG
MMPPPPMMMMMMJJJJJJJGGGGGDDDGGGGGGGGGGDDDGGGGGGGGGG
MMPPMPMMMMJMMJJJJJJGGGGGGGGGGGGGGGGGGDAAADDDDGGGGG
JMPPMPMMMMJMMJJJJJJGGGGGGGGGGGGGGGGGDAAAAAAADGGDDG
MPPPPPPMMMJJMJJJJJJJGGGGGGGGGGGGGGGDAAAAAAAADDDDDD
MMMMPPPMMMMJJMJJJJJJJGGGGGGGGGGGGGGDAAAAAAAAAAAAAD
PPPPPPPPPPMJJMJJJJJJJJGGGGGGGGGGGGDAAAAAAAAAAAAAAA
PPPPPPPPPMJJMMJJJJJJJJJGGGGGGGGGGGDDAAAAAAAAAAAAAA
PPPPPPPMMMMMMMJMJJJJJJJGGGGGGGGGGGGDAAAAAAAAAAAAAA
PPPPPPMMMMMMMMMMJJJJJJJJGGGGGGGGGGGAAAAAAAAAAAAAAA
PPPPPPMMMMMMMMMMMJJJJJJJGGGGGGGGGGGDAAAAAAAAAAAAAA
PPPPPMMMMMMMMMMMJJJJJJJJJJGGGGGGGGGDAAAAAAAAAAAAAA
