AAAAAAAAAAAAAAAAAAAAAAAAADGGGGDDDAAAAAAAAAAAADGGGJ
AAAAAAAAAAAAAAAAAAAAAAAAADDGDDAAAAAAAAAAAAAAADGGGG
DDDAAAAAAAAAAAAAAAAAAAAAADDDDDAAAAAAAAAAAAAADDGGGG
GGDAAAAAAAAAAAAAAAAAAAAAAAAADAAAAAAAAAAAAAAAAAGGGG
GGDAAAAAAAAAAAAAAAAAAAAAAAADDDAAAAAAAAAAAAAAAAGGGG
GGDDAAAAAAAAAAAAAAAAAAAAAAADDDAAAAAAAAAAAAAAAAGGGG
GGGDDAAAAAAAAAAAAAAAAAAAAAADDAAAAAAAAAAAAAAAAADGGG
GGGGDAAAAAAAAAAAAAAAAAAAAAADDAAAAAAAAAAAAAAAADGGGG
GGGDDAAAAAAAAAAAAAAAAAAAAAADDDDDAAAAAAAAAAAAAGGGGJ
GGGDDAAAAAAAAAAAAAAAAAAAAAAAADDDDDDAAAAAAAAADGGGGJ
GGDDDDAAAAAAAAAAAAAAAAAAAAAADDDGDDAAAAAAAAAADGGGJJ
GGGDDDAAAAAAAAAAAAAAAAAAAADDDDGGDAAAAAAAAAAAGGGGJJ
GDDDDAAAAAAAAAAAAAAAAAAAAAADDDDDDAAAAAAAAAAADGGGJJ
GDDDDAAAAAAAAAAAAAAAAAAAAAAADDDDDDAAAAAAAAADGGGGJJ
DDDDAAAAAAAAAAAAAAAAAAAAAAAADGGGGDAAAAAAAAADGGGJJJ
ADDDAAAAAAAAAAAAAADDAAAAAAADDDGGGDDDDDAAAADGGGJJJJ
AAAAAAAAAAAAAAAAADDDDDAAAADGDGGGGGGGDDDDDDGGGGGJJJ
AAAAAAAAAAAAAAAAADDDDDDDAADDGGGGGGGGGGGGGGGGGGGJJJ
AAAAAAAAAAAAAAAAAAADDDAADDDGGGGGGGGGGGGGGGGGGGJJJJ
AAAAAAAAAAAAAAAAAAADADAADGGGGGGGGGGGGGGGGGGGGJJJJJ
AAAAAAAAAAAAAAAAAAAAADADDGGGGGGGGGGGGGGGGGGGGJJJJJ
AAAAAAAAAAAAAAAAAAAAADDDGGGGGGGGGGGGGGGGGGGGJJJJJJ
AAAAAAAAAAAAAAAAAAADDGGGGGGGGGGGGGGGGGGGGGJJJJJJJJ
AAAAAAAAAAAAAAAAAADDGGGGGGGGGGGJGGGGGGGGGGJJJJJJJJ
AAAAAAAAAAAAAAAAADGGGGGGGGJJJJJJGGGGGGGGJJJJJJJJJJ
AAAAAAAAAAAAAAAADGGGGGGGGJJJJJJJGJJJJGGGGJJJJJJJJJ
AAAAAAAAAAADDADGGGGGGGGGJJJJJJJJJJJJJGGGGJJJJJJJJJ
DDAAADDADDDGGGGGGGGGGGJJJJJJJJJJJJJJJJJJJJJJJJJJJJ
GDGDDDGDDDGGGGGGGGJJJJJJJJJJJJJJJJJJJJJJJJJJJJJJJJ
GGGGGGGGGGGGGGGGGJJJJJJJJJJJJJJJJJJJJJJJJJJJJJJJJJ
GGGGGGGGGGGGGGGJJJJJJJJJJJJJJJJJJJJJJJJJJJJJJJJJJJ
GGGGGGGGGGGGGGGJJJJJJJJJJJJJJJJJJJJJJJJJJJJJJJJJJJ
GGGGGGGGGGGGGGGGJJJJJJJJJJJJJJJJJJJJJJJJJJJJJJJJJJ
GGGGGGGGGGGGGGGGJJJJJJJJMMJJJJJJJJJJJJMMMJMMJJJJJJ
GGGGGGGGGGGGGGGGGJJJJJMMMMJJJJJJJJMMJMMMMJJMJJJJJJ
GGGGGGGGGGGGGGGGGJJJJJMMMMJJJJJJJJJMMMMMMJJMMJJJJJ
GGGGGGGGGGGGGGGGGJJJJJMMMMMJJJJJJJJJJJMJMMMMMJJJJJ
GGGGGGGGGGGGGGGGGJJJJJMMJMJJJJJJJJJMMMMMMMMMMJJJJJ
GGGGGGGGGGGGGGGGGJJJJJJJJJJJJJJJJJJMMMMMPMMPMMJJJJ
GGGGGGGGGGGGGGGJJJJJJJJJJJJJJJJJMMJMMMMPPMMPMMJJJJ
GGGGGGGGGGGGJJJJJJJJJJJJJJJJJJJJMMMMMMPPPMPPMMJJGG
GGGGGGGGGGJJJJJJJJJJJJJJJJJJJJJMMJMMPPPPPPMMMMMJJG
GGGGGGGGJJJJJJJJJJJJJJJJJJJJMMJMMMMMPPPPPPMMMJJJJJ
GGGGGJJJJJJJJJJJJJJJJJJJJJJJMMMMMMMMPPPPMMMJMJJMJJ
GGGGGJJJJJJJJJJJJJJJJJGGJJJJJMMMMMMPPPMMMJMMJMMJJM
GGGGGGJJJJJJJJJJJJJJJJGGGJJJJMMMMMMMMMMPMMJMMJMMJJ
GGGGGGJJJJJJJJJJJJJJJJJGGJJJJJMPMMMJMJMPMMMMPMPMMJ
GGGGGGJJJJJJJJJJJJJJJJJGGGJJJJMMJMMJJJPMMPPMMPMMJJ
GGGGGGJJJJJJJJJJJJJJJJJJGJJJJMMJJMMJJMMMMPMPPPPMPM
GGGGGGJJJJJJJJJJJJJJJJJJJJJJJJMJMJJJMMJMMMPMPPPPPP
