JJJJJJJJJJJJJJJJJJGGGDDDDDDDDDDGGGGGGGGGGGGJJJJJJJ
JJJJJJJJJJGGGJJJJJGGGGGDDGGDDDDGGGGGGGGGGGGGJJJJJJ
JJJJJJJJJJJGGGGGGGGGGGGGGGGDDDDGGGGGGGGGGGGGGGJJJJ
JJJJJJJJJJJGGJGGGGGGGGGGGGGGDDDGGGGGGGGGGGGGGGJJJJ
JJJJJJJJJJGGJGGGGGGGGGGGGGDDDDDDGGGGGGGGGGGGGJJJJJ
JJJJJJJJJJJGGGGGGGGGGGGGGDDDDDDDGGGGGGGGGGGGGGJJJJ
MMMMMJJJJJJJJGGGGGGGGGGGDDDDDDDDGGGGGGGGGGGGGGJJJJ
MMMMMJJJJJJJJJJJGGGGGGDDGDDDDDDDGGGGGGGGGGGGGGGJJJ
MMMMMJJJJJJJJJJJJGGGGGGGGDDDDDDGGGGGGGGGGGGGGJJJJJ
MMMMMJJJJJJJJJJJJGGGGGGGGDDDDDDDGGGGGGGGGGGGGJJJJJ
JJMMMMJJJGGJJJJJGGGGGGGGGDDDDDDDDGGGGGGGGGGGJJJJJJ
MMMMMMJJJJJJJJJJJJJGGGGDDDDDDDDDDDGGGGGGGGGJJJJJJJ
MMMJMMJJJJJJJJJJJJJGGGGDDDDDDDDDDDGGGGGGGGGJJJJJJJ
JJMJJMMJJJJJJJJJJJJGGGDDDDDDDDDDDDDGGGGGGGGJJJJJJJ
JJMJJJMJJJJJJJJJJJJGGGDDDDDDDDDDDDDDGGGGGGJJJJJJJJ
JMMMJJJJJJJJJJJJJJGGGDDDDDDDDDDDDDDDDGGGGGJJJJJJJJ
MMJJJJJJJJJJJJJJJJJGGGDDDDDDDDDDDDDDDGGGGGGJJJJJJJ
MMJJJJJJJJJJJJJJJJJGGGDDDDDDDDDDDDDDDGGGGGGJJJJJJJ
MMMJMJJJJJJJJJJJJJJGGGDDDDDDDDDDDDDDDDDGGGGJJJJJJJ
MMMMMMJJJJJJJJJJJJGGGDDDDDDDDDDDDDDDDDDDGGGJJJJJJJ
MMMMMMJJJJJJJJJJJGGGGGDDDDDDDDDDDDDDDDDDGGGGGGJGGJ
MMMMMJJJJJJJJJJJGGGGGGGGGDDDDDDDDDDDDDDDDGGGGGGGJJ
MMMMMMJJJJJJJJGGGGGGGGGGGDDDDDDDDDDDDDDDDDDGGGGGJJ
MMMMMMJJJJJJJJGGGGGGGGGGDDDDDDDDDDDDDDDDDDDGGGGGJJ
MMMMMJJJJJJJJJGGGGGGGGGGDDDDDDDDDDDDDDDDDDDDGGGGGJ
MMMMMJJJJJJJJJGGGGGGGGGGDDDDDDDDDDDDDDDDDDDDDGGGGG
MMPMMJJJJJJJGGGGGGGGGDDDDDDDDDDDDDDDDDDDDDDDDDGGGG
MMMMMJJJJJJGGGGGGGGGGDDDDDDDDDDDDDDDDDDDDDDDDDDGGG
MMMMMJJJJJJGGGGGGGGGGDDDDDDDDDDDDDDDDDDDDDDDDDDDGG
MMMMJJJJJJJGGGGGGGGGGDDDDDDDDDDDDDDDDDDDDDDDDDDDDG
JMJJJJJJJJJJJGGGGJGGGDDDDDDDDDDDDDDDDDDDDDDDDDDDDG
JJJJJJJJJJJGJJGGJJGGGDDDDDDDDDDDDDDDDDDDDDDDDDDDGG
MJJJJJJJJJGGGJJJJGGGGDDDDDDDDDDDDDDDDDDDDDDDDDDDDG
JJJJJJJJJJJGGGGGGGGGGDDDDDDDDDDDDDDDDDDDDDDDDDDDDD
JJJJJJJJJJGGGGGGGGGGDDDDDDDDDDDDDDDDDDDDDDDDDDDDDD
MJJJJJJJJJGGGGGGGGGGGDDDDDDDDDDDDDDDDDDDDDDDDDDDDD
MJJJJJJJJGGGGGGGGGGGGDDDDDDDDDDDDDDDDDDDDDDDDDDDDD
MMMJJJJJJGGGGGGGGDDDGDDDDDDDDDDDDDDDDDDDDDDDDDDDDG
MMMJJJJJJGGGGGGGDDDDGGDDDDDDDDDDDDDDDDDDDDDDGGGGGG
MMJJJJJJJJGGGGGGGDDDDGDDDDDDDDDDDDDDDDDDDDDDGGGGGG
MMMJJJJJJJJJJGGGGDDDGGGDDDDDDDDDDDDDDDDDDDDDGGGGGJ
MMMJJJJJJJJJJJGGGDDDGGDDDDDDDDDDDDDDDDDDDDDDGGGJJJ
PPMMJJJJJJJJJJJGGGDDGGGDDDDDDDDDDDDDDDDDDDDGGGJJJJ
PPMJMMJJJMMJJJJGGGGGGGGDDDDDDDDDDDDDDDDDDDGGGJJJJJ
PPPMMMJJJMMJJJJJJGGGGGGDDDDDDDDDDDDDDDDDDGGGGJJJJJ
PPPMMMMMJJMJJJJJJJGGGGGDDDDDDDDDDDDDDGGGGGGGJJJJJJ
PPPMMMJJJJJJJJJJJJJJGGDDDDDDDDDDDDDDGGGGGGGJJJJJJJ
PPPMPMMJJMJJJJJJJJJJGGDDDDDDDDDDDDDDGGGGGGJJJJJJJJ
PMPPMMMMJJJMMMJJJJJJGGDDDDDGGGGDDGDGGGGGGJJJJJJJJJ
PMMMMMMMJMMMMMMMMJJJGGGGGGGGGGGGGGDGGGGGGJJJJJJJJJ
