JJGGGGJJJJJJMJJJJJJJJJJJMMMMJJJMJMJMMMMPPPPPPPPPPP
JJJGGJJJJJJJJJJJJJJJJJJJJJMMJMMPMMJMMMMPPPPPPPPPPP
JJJGJJJJJJJJJJJJJJJJJJJJJJJMJJMPPJJMMPMPPPPPPPPPPP
JJJJJJJJJJJJJJJJJGJJJJJJJJJJMMMPPMJMPPMMMPPPPPPPPP
JJJJJJJJJJJJJJJJJGJGGJJJJJJJMJMPPMMJMPMPPPPPPPPPPP
JJJJGJJJJJJJJJJJGGGGGJJJJJMMMMMPPMMJJPPPPPPPPPPPPP
JJJJJJJJJJJJJJJJGGGGGJJJJJJMMPPPMPPMMPPPPPPPPPPPPP
JJJJJJJJJJJJJJJJGGGGGJJJJJJMPPPMPPPMPPPPPPPPPPPPPP
JJJJJJJJJJJJJJJJGGGGGJJJJJMMMMPPPPPPPPPPPPPPPPPPPP
JJJJJJJJJJJJJJJGGGGGGJJJJJMMMPPPPPPPPPPPPPPPPPPPPP
JJJJJJJJJJJJJJJGGGJJJJJJJJMJMMPPPPPPPPPPPPPPPPPPPM
JJJJJJJJJJJJJJJGGGJJJJJJJJJMMMPPPPPPPPPPPPPPPPMPPM
JJJJJJJJJJJJJJJJGJGJJJJJJMJMMMMPPPPMPPPPPPPPPMPMMJ
JJJJJJJJJJJJJJGGGJGJJJJJJMMMMMPPPMPPPPPPPPPPPPPMMP
JJJJJGGGGGGGJJGGGGGJJJJJJMMMMMPMMMMMMPPPPPPPPPPPPP
GGGGGGGGGGGGGGGGGGJGJJJJJJMMMMMMMMMMMPPPPPPPPPPPPP
GGGGGGGGGGGGGGGGGGJJJJJJJMMMMMMMMMJMMMPPMPPPPPPMPM
JGGGGGGGGGGGGGGGGGGJJJJJJJMMMMJJMJJMMMPPMMMMPPMMMM
JGGGJGGGGGGGGGGGGGGGJJJJJJJJMJJJMJJMMPPMMJMMPMMJJJ
JJGGJJJGGGGGGGGGGGGGJJJJJJJJJJJJMMMMMMMMMMMMMMMJJJ
JJJJJJJGGGGGGGGGGGGGGJJJJJJJJJJJJJMMMMMMJJMJJJMJJJ
JJJJJJJJGGGGGGGGGGGGGGGJJJGJJJJJJJJMMMMMJJJJJJJJJJ
JJJJJJGGGGGGGGGGGGGGGGGGJGGJJJJJJJJMMMMMJJJJJMJJJJ
JJJJJJGGGGGGGGGGGGGGGGGGGGGGGJJJJMMMMMMMJJJJJJJJJJ
JJJJJJGGGGGGGGGGGGGGGGGGGGGGGJJJJJMJMMJJJJJJJJJJJJ
JJJGGGGGGGGGGGGDDDDGGGGGGGGGGGJJJJJJJJJJJJJJJJJJMJ
JJJGGGGGGGGGGGDDDDGDGGGGGGGGGGGGJJJJJJJJJJJJJJJJJJ
JJJGGGGGGGGGDGDDDDDDDGGGGGGGGGGGGGJJJJJJJJJJJJJJJJ
JJJJGGGGGGGDDDDDDDDDDGGGGGGGGGGGGGGJJJJJJJJJJJJJJJ
JJJJJGGGGGGGDDDDDDDDGGGGGGGGGGGGGGGGGGJJJJJJJJJJJJ
JJJGGGGGGGGDDDDDDDDDDGGGGGGGGGGGGGGGGGJJJJJJJJJJJJ
JGGGGGGGGGGGGDDDDDDDGGGGGGGGGGGGGGGGGGJJJGGJJJJJJJ
JGGGGGGGDDDDDDDGDDDDGGGGGGGGGGGGGGGGGGGJGJGJJJJJJJ
GGGGGGGGDAADDDDGDDDGGGGGGGGGGGGGGGGGGGGGGJJJJJJJMJ
GGGGGGDDDAADDDDDDAAADGGGGGDDDGGGGGGGGGGGGGJJJJJJMJ
GGGGGGDDDADADAADAAAAADDDAADDDGGGGGGGGGGGGGJJJJJJJJ
GGGGGGDAAAAAAAAAAAAAADAAAAADGGGGGGGGGGGGGGJJJJJJJJ
DGGGGGDAAAAAAAAAAAAADDDAAADDGGGGGGGGGGGGGGJJJJJJJJ
DDDDDDDAAAAAAAAAAAAADDDAADDGGGGGGGGGGGGGGJJJJJJJJJ
ADDDDAAAAAAAAADDDDDDDDDDDDGGGGGGGGJJJJJJGJJJJJJJJJ
AADAAAAAAAAAADDGDGGDDDDDDGGGGGGGGJJJJJJJJJJJJJJJJJ
AAAAAAAAAAAAADDGGGGGGGGGGGGGGJJGJJJJJJJJJJJJJJJJJJ
AAAAAAAAAAAAADGGGGGGGGGGGGGGGJJJJJJJJJJJJJJJJJJJJJ
AAAAAAAAAAAAADDGGGGGGGGGGGGGGJJJJJJJJJJJJJJJJJJJJJ
AAAAAAAAAAAAADGGGGGGGGGGGGGGJJJJJJJJJJJJJJJJJJJJJJ
AAAAAAAAAAAAADGGGGGGGGGGGGGJJJJJJJJJJJJJJJJJJJJJJJ
AAAAAAAAAAAAADGGGGGGGGJJJJJJJJJJJJJJJJJJJJJJJJJJJM
AAAAAAAAAAAADGGGGGJJJJJJJJJJJJJJJJJJJJJMMJMMJJMMMJ
AAAAAAAAAAAAGGGGGJJJJJJJJJJJJJJJJJJJJJJMMMMMMMMMMJ
AAAAAAAAAADGGGGJJJJJJJJJJJJJJJJJJJJJJJJJJMMMMMMMJJ
