GGGGGGGGGGGGGGDGDAAAAAADDDDDGGGGGGGGGJJJJJJJJJJJMM
GGGGGGGGGGGGGDDDDAAAAAAAAADDGGGGGGGGJJJJJJJJJJJJMM
GGGGGGGGGGGGDAADAAAAAAAAAAAGGGGGGGJJJJJJJJJJJJJMMM
GGGGGGGGGGGDAAAAAAAAAAAAAADDGGGGGGJJJJJJJJJJJJJMMM
GGGGGGGGGGGDAAAAAAAAAAAAAAAADGGGGGJJJJJJJMJJJJJMMM
GGGGGGGGGGDDAAAAAAAAAAAAAAADDGGGGJJJJJJJJMJJJJJMMM
GGGGGGGGGGDDAAAAAAAAAAAAAAADGGGGGGJJJJJJJJJJJJJMJM
GGDGDDDGGGDDAAAAAAAAAAAAADADGGGGGGJJJJJJJJJJJJJJJM
DDADADDDDDDDAAAAAAAAAAAAADADGGGGGJJJJJJJJJJJJJJMMM
DAAAAAAAAAAAAAAAAAAAAAAAADDGGGGGGGJGGJJJJJJJJJMMMM
AAAAAAAAAAAAAAAAAAAAAAAAADDGGGGGGGGGGGJJJJJJJJMJMJ
AAAAAAAAAAAAAAAAAAAAAAAAAADGGGGGGGGGGGJJJJJJJJJJJM
AAAAAAAAAAAAAAAAAAAAAAAAAADGGGGGGGGGGGJJJJJJJJJJJM
AAAAAAAAAAAAAAAAAAAAAAAAAAGGGGGGGGGGGGJJJJJJJJJJJJ
AAAAAAAAAAAAAAAAAAAAAAAAADGGGGGGJGGGJJJJJJJJJJJJJJ
AAAAAAAAAAAAAAAAAAAAAAAAADGGGGGGJJJJJJJJJJJJJJJJJJ
AAAAAAAAAAAAAAAAAAAAAAAAADGGGGGJJJJJJJJJJJJGGGGJJJ
AAAAAAAAAAAAAAAAAAAAAAAAADGGGGGJJJJJJJJJJJJJGGJJJJ
AAAAAAAAAAAAAAAAAAAAAAAAADGGGGGJJJJJJJJJJJJJGJJGJJ
AAAAAAAAAAAAAAAAAAAAAAAAAAGGGGGGJJJJJJGJJJJJGGGGJJ
AAAAAAAAAAAAAAAAAAAAAAAAAAGGGGGGGGGGGGGGGJJGGGGJJJ
AAAAAAAAAAAAAAAAAAAAAAAAAADGGGGGGGGGGGGGGGGGGGGJJJ
AAAAAAAAAAAAAAAAAAAAAAAAAAAGGGGGGGGGGGGGGGGGGJJJJJ
AAAAAAAAAAAAAAAAAAAAAAAAAAADGGGGGGGGGGJGGGJGGJJJJJ
AAAAAAAAAAAAAAAAAAAAAAAAAAADGGGGGGGGGGJJJJGGGJJJJJ
AAAAAAAAAAAAAAAAAAAAAAAAAAADGGGGGGGGGGJJJJGJJJJJJJ
AAAAAAAAAAAAAAAAAAAAAAAAAAAADGGGGGGGGGGJGGGJJJJJJJ
AAAAAAAAAAAAAAAAAAAAAAAAAAAAADGGGGGGGGGGGGGJJJJJJJ
ADAAAAAAAAAAAAAAAAAAAAAADDDAAAADGGGGGGGGGGGGGJJJJJ
DGDAAAAAAAAAAAAAAAAAAAAAADDAAAAGGGGGGGGGGGGGJJJJJJ
GGDDDAAAAAAAAAAAAAAAAAAAAAAAAADGGGGGGGGGGGGGJJJJJJ
GGGGDAAAAAAAAAAAAAAAAAAAAAAAAADDGGGGGGGGGGGGJJJJJJ
GGGGGGDDDAAAAAAAAAAAAAAAAAAAAADGGGGGGGGGGGGJJJJJJJ
GGGGGGGGGDAAAAAAAAAAAAAAAAAAAADGGGGJJGGGGGJJJJJJJJ
GGGGGGGGGDDDAAAAAAAAAAAAAAAAAAGGGGJJJJGGGGJJJJJJJJ
GGGGGGGGGGGDDAAAAAAAAAAAAAAADDGGGGJJJJGJJJJJJJJJJJ
GGJGGGGGGGGGGDDDAAAAAAAAAAADGGGGGJJJJJJJJJJJJJJJJJ
GGJGGGGGGGGGGGDDAAAADAAAADDGGGGGGJJJJJJJJJJJJJJJJJ
GGGGGGGGGGGGGGDDDGDGGDAAADGGGJJJJJJJJJJJJJJJJJJJJJ
JJJJGGGGGGGGGGGGGGGGGGADGGGJJJJJJJJJJJMJJJJJJJJJMM
JJJJGGGGGGGGGGGGGGGGGGGDGGGJJJJJJJJJJJJMMMMMMJJJMM
JJJJGGGGGGGGGGGGGGGGGGGGGGGJJJJJJMJMMJMMMJMMJJJMMM
JJJJGGGGGGGGGGGGGGGGGGGGGJJJJJJMMMMMMMMMMMMMJMMMMM
JJJJGGGGGGGGGGJJJGGGJJJJJJJJJJJJMMMMPMMMMMMMMJMMMM
JJJJGGGGGGGGGGJJJJJJJJJJJJJJJJMJMMMMPPPMMMMMMJMMMM
JJJJJGGGGGGJGGJJJJJJJJJJJJJJJJMJMMMPPMMPPPPPMJMMPM
JJJJJJGJJJJJJJGJJJJJJJJJJJJJJJMMMMMMMMMPPPPPMMMMMM
JJJJJJJJJJJJJJJJJJJJJJJJJJJJJJJMMMMMMMPPPPPMPMMMMM
JJJJJJJJJJJJJJJJJJJJJJJJJJJJJJMMMMMMMPPPPPPPPMMMJJ
JJJJJJJJJJJJJJJJJJJJJJJMMMMMJMMMMMMMPMPPMMMPMMJMMJ
