PPPPPPPPPPPPPPMPPPPPPPPPPPPPPPPPMMMPPMMPMJJJJJJJJJ
PPPPPPPPPPPPPPPMPPPPPPPPPPPPPPPMMMMMMMMMMMMMJJJJJJ
PPPPPPPPPPPPPPPPPPPPPPPPPPPPPMMMMMMMMMMMMMMMJJJJJG
MMPPPPPPPMMPPPPMMMPPMPPPPPPPMMJMMPMMJMMMMMJJJJJJJJ
MPPPPPPPPPPMJJPMPPPPPPMMPPPPMMMPMMMMMMMJMMMMJJJJJJ
JJPPMPPPPPPMMJJMJMPPMJMMMMMMMMMMMMMJJMMJJMMMMJJJJJ
MJPPPPPPPPPMMMPPJJMJJJJJMJMMMMMJMMMJJJJJJJJJJJJJJJ
MMPMMPPPMPPPPPPJMPMJMMMMMJMMMMMJJJJMMMJMJJJJJJJJJJ
MMMPPPPPPPPMPPMJMJJJMMMJJJJMMMMJJJJMMMMJJJJJJJJJJJ
JPMPPPPPMPPMPMMMMJJJJJJJJJJJJJJJJJMJMMMJJJJGJJJJJJ
JMMMPPPPPMMMJMJJJJJJJJJJGGJJJJJJJJJJJMMJJJJJJJJJJJ
JMJMMPMMJJJJJJJMMJJJJJJGGGGGGGJJMMJJMMMMJJJJJJJJGJ
JJJMMMMMMMJJJJJJJJJJJJGGGGJGGJJJJMJJMMMJJJJJGJJJJJ
JGJJJJJMJJJJJJJJJJJJJGGGGGJGGJJJJJJJMMJMJJJJJJJJJJ
JJJMJMJJJJJJJJJJJJJGJJGGGGGGGJJJJJJJJMJJJJJJJJJJJJ
JJJMJJJJJJJJJJJJJJJJJGGGGGGJGJJJJJJJJJJJJJJJJJJJJJ
JJMJMJJJJJJJJJJJJJJJJJGGGGGGGGJJJJJJJJMMJJJJJJJJJM
MMJJMMJJJJJJJJJJJJJJJJGGGGGGJJJJMJJJJMJMJJJJJJJJJJ
MMMJJJJJJJJJJJJJJJJJJJJGGGGGGGJJJJJJJJMMMJJJJJJJJM
MMMJJJJJJJJJJJJJJJJJJJGGGGGGGGJJJJJJJJMMJMJJJJJJJM
MMJJJGGGGGGJJJJJJJJJJJJGGGGGGGGJJJJJJMMMJJJJJJJJMM
JJJJJGGGGGGGGGJJJJJJJJGJGGGGGGGGJJJJJMMMMMMMJMMMMM
MJJJJGGGGGGGGGGJJJJJJGGGGGGGGJJGJJJJJJMMMMMMMMMMMM
MJJJJJJGGGGGGGGGGJJJJJJJGGGGGJGGJJJJJMMMMMMMMMMMMM
MMJJJJJJJJJGGGGGGGGGJJJGGGGJJJJJJJJJJMMMMMMMMMMMMJ
JJJJJJJJJJJGGGGGGGGJJGGGGGGJGJJJJJJJJJMMMMMMMMJJJJ
JJMJJJJJJJJGGGGGGGGGGGGGGGGGGGGGJJJJJMMMMMMMJJJJJJ
JJJMJJJJJGJGJGGGGGGGGGGGGGGGGGGGJJJJJJJMMMMJJJJJJJ
JJJJJJJJJJJJJJGGGGGGGGGGGGGGGGGGJJJJJJJJJMJJJJJJJJ
JJJJJJJJJJJJJJGGGGGGGGGGGGGGGGGGJJJJJJJJJJMJJJJJJG
JJJJJJJJJJJJJGGGGGGGGGGGGGGGGGGGJJJJJJJJJJJJJJJJJG
JJJJJJJJJJJJJGGGGGGGGGGGGGGGGGGGGGJJJJJJJJJJJJJJGG
JJJJJJJJJJJJGGGGGGGGGGGGGGGGGGGGGGJJJJJJJJJJJJJGGG
JJJJJJJJJJJJGGGGGGGGGGGGGGGGGGGGGGGGJJJJJJJJJGGGGG
JJJJJJJJJJJJJGGGGGGGGGGGGGGGGGGGGGGGJJJJJJJJJGGGGG
JJJJJJJJJJJJJJJGGGGGGGGGGGGDGGGGGGGGJJJJJJJJGGGGGG
JJJJJJJJJJJJJJJJJGGGGGGGGGGDDGGGGGJJJJJJJJJJGGGGGG
JJJJJJJJJJJJJJJJJJGGGGGGGGGDAADGGGGGGGJJJJJGGGGGGG
JJJJJJJJJJJJJJJJJJGGGGGGGGDDDDGGGGGGGGGJGGGGGGGGGG
JJJJJJJJJJJJJJJJJJGGGGGGDDDDADDGGGGGGJJJGGGGGGGGGG
JJJJJJJJJJJJJJJJGGGGGGGDDAAAAADGGGGGGGJJJGGGGGGGGG
JJJGJJJJJJJJJJJJGGGGGDAAAAAAAAAGGGGGGJJJJGGGGGGGGG
JJJGGGGJJJJJJJJGGGDDAAAAAAAAAAADGGGGGJJJGGGGGGGGGG
JJJGGGGJJGGGGJGGGDAAAAAAAAAAAAADGGGGGGJJGGGGGGGGGG
JJGGGGGGGGGGGGGGGDAAAAAAAAAAAAADDGGGGGGGJGGGGGGGGG
JJGGGGGGGGGGGGGGGDAAAAAAAAAAAAAADDGGGGGGGGGGGGGGGG
JGGGGGGGGGGGGGGGDDAAAAAAAAAAAAAAADDDDGGGGGGGGGGGGG
JGGGGGGGGGGGGGGDAAAAAAAAAAAAAAAAAAAADGGGGGGGGGGGGG
JJGGGGGGGGGGGGGAAAAAAAAAAAAAAAAAAAAAADGGGGGGGGGGGG
JJGGGGGGGGGGGGDAAAAAAAAAAAAAAAAAAAAAAADDGGGGGGGGGG
