DDDDDDDDDGGGGGGGJGGJJJJJJJJMMJJMMMMMMMMMMMMMMJJJMM
DDDDDDDDDGGGGGGGGJJJJJJJJJJMMJJJMMMMMMMJJMMJJJJJJJ
DDDDDDDDDGGGGGGGJJJJJJJJJJMMMJJJJMMMMMMMMMJJJJJJJM
DDDDDDDDDGGGGGGJJJJJJJJJJJMMMJJJJJJJMMJMJJJJJJJJJJ
DDDDDDDDDDGGGGGJJJJJJJJJJJMJJJJJJJJJJMJJJJJJJJJJJJ
DDDDDDDDDDGGGGGJJJJJJJJJJJJJJJJJJJMMJJJJJJJJJJJJJJ
GDDDDDDDDDGGGGGJJJJJJJJJJJJJJJJJJJJJJJJJJJJJJJJJJJ
GDDDDDDDDDDGGGGGJJJJJJJJJJJJJJJJJJJJJJJGJJJJJJJJJJ
DDDDDDDDDDDGGGGGGJJJJJJJJJJJJJJJJJJJJJJJJJJJJJJJJJ
DDDDDDDDDDDGGGGGGJJJJJJJJJJJJJJJJJJJJJJJJJJJJJJJJJ
DDDDDDDDDDDDDGGGGGJJJJJJJJJJJJJJJJJJJJJJJJJJJJJJJJ
DDDDDDDDDDDDDGGGGGJJJJJJJJJJJJJJJJJJJJJJJJJJJJJJJJ
GGDDDDDDDDDDDGGGGGJJJJGJJJJJJJJJJJJJJJJJJJJJJJJJJJ
GGDDDDDDDDDDDGGGGGGGGGGGGJJJJJJJJJJJJJJJJJJJJJJJJJ
GDDDDDDDDDDDDGGGGGGGGGGJJJJJJJJJJJJJJJJJJJJJJJJJJJ
GDDDDDDDDDDDGGGGGGGGGGJJJJJJJJJJJJJJGJJJJJJJJJJJJJ
DDDDDDDDDDDGGGGGGGGGGGJJJGGJGGJGJJJGGGGJJJJJJJJJJJ
GDDDDDDDDDDGGGGGGGGGGGJGJGGJGGJGGGGGGGGJJJJJJJJJJJ
GGDDDDDDDDDGGGGGGGGGGJJGJGGGGGGGGGGGGGGGGGJJGJJJJJ
GGGGDDDDDGGGGJGGGGGGGGGGGGJGGGGGGGGGGGGGGGGGGJJJJG
GGGGDDGDGGGGGJJJGGGGGGGGGJJGGGGGGDDGDGGGGGGGGGGGGG
JGGGGGGGGGGGGJJJGGGGGGGGGGGGGGGDDAADDDGGGGGGGGGGGG
JJJGGGGGGGGGGJJJGGGGGGGGGGGGGDDDAAAAADDGGDGGGGGGGG
JJJJJJGGJGGGJJJGGGGGGGGGGGGGDAAAAAAAADDDDDDGGGGGGG
JJJJJJJGJJGGGJJGGGGGGGGGGGGDAAAAAAAAAAAAAAAGGGGGGG
JJJJJJJJJGGGGGGGGGGGGGGGGDDDAAAAAAAAAAAAADDDGGGGGG
JJJJJJJJJJGGGGGGGGGGGDDDDAAAAAAAAAAAAAAAADDDGGGGGG
JJJJJJJJJJGGGGGGGGGGGDAAAAAAAAAAAAAAAAAAAADDGGGGGG
MMMJMMJJJJJGGGGGGGGGGAAAAAAAAAAAAAAAAAAAAADGGGGGGG
MMMMMMJJJJJGGGGGGGGGGDAAAAAAAAAAAAAAAAAAAAAGGGGGGG
MMMMMMMMJJJJJJJGGGGGGDAAAAAAAAAAAAAAAAAAAADDGGGGGG
MMMMMMMMJJJJJJJJGGGGGDAAAAAAAAAAAAAAAAAAADDDGGGGGG
MMMMMMMJJJJJJJJJJGGGGDAAAAAAAAAAAAAAAAAAADDGGGGGGG
MMMMMMJJJJJJJJJJGGGGDAAAAAAAAAAAAAAAAAAAADDGGGGGGG
MMMMMJJJJJJJJJJGGGGGDAAAAAAAAAAAAAAAAAAAAADGGGGGGG
MMMMMJJJJJJJJJGGGGGDAAAAAAAAAAAAAAAAAAAAADDGGGGGGG
MMMMMJJJJJJJJGGGGGDDDAAAAAAAAAAAAAAAAAAAAAAADDGGGG
MMMMMJJJJJJJJGGGGDDDDAAAAAAAAAAAAAAAAAAAAAAAADGGGG
MMMMJJJJJJJJGGGGDDAAAAAAAAAAAAAAAAAAAAAAAAAAAADDDD
MMMMMJJJJJJJGGGGDAAAAAAAAAAAAAAAAAAAAAAAAAAAAADDDD
PPMMMJJJJJJGGGGGGAAAAAAAAAAAAAAAAAAAAAAAAAADAADDDD
PMMMMJJJJJJGGGGGGDAAAAAAAAAAAAAAAAAAAAAAAAAAAADDDD
PMMMMJJJJJJJGGGGDAAAAAAAAAAAAAAAAAAAAAAAAAAAAADDDD
MMMMJJJJJJJJGGGGDAAAAAAAAAAAAAAAAAAAAAAAAAAADDDDDD
MMMMJJJJJJJJJGGGDAAAAAAAAAAAAAAAAAAAAAAAAAAADDDDDD
MMMMJJJJJJJJJGGGGDDAAAAAAAAAAAAAAAAAAAAAAAAADGGGGG
MMJJJJJJJJJJJJGGGGDDDAAAAAAAAAAAAAAAAAAAAAAADGGGGG
JJJJJJJJJJJJJJGGGGGAAAAAAAAAAAAAAAAAAAAAAAAADGGGGG
MJJJJJJJJJJJJJJGGGGAAAAAAAAAAAAAAAAAAAADDAADDGGGGJ
MJJMJJJJJJJJJJJJJGGGAAAAAAAAAAAAAAADAADGGDDGGGGGGJ
