GGGGDDDDDDDDDDDDDDDDDDGGGGJGJJJGGJJJJJJJJJJJJJJMMM
GGGGDDDDDDDDDDDDDDDDDGGGGGGGGGGGJJJJJJJJJJJJJJMMMM
GGGDDDDDDDDDDDDDDDDDDDGGGGGGGGGGGJJJJJJJJJJJJJJMMM
GGGDDDDDDDDDDDDDDDDDDDGGGGGGGGGGGJJJJJJJJJJJJJJJMM
DDDDDDDDDDDDDDDDDDDDDDGGGGGGGGGGGJJJJJJJJJJJJJJJJJ
DDDDDDDDDDDDDDDDDDDDDGGGGGGGGGGGGGJJGJJJJJJJJJJJJJ
DDDDDDDDDDDDDDDDDDDDDGGGDDDGGDDGGGGGGGGJJJJJJJJJJM
DDDDDDDDDDDDDDDDDDDDDDDDDDDDDDDDGGGGGGGGJJJJJJJJMM
DDDDDDDDDDDDDDDDDDDDDDDDDDDDDDDDGGGGGGGGJJJJJJJMMM
DDDDDDDDDDDDDDDDDDDDDDDDDDDDDDDDGGGGGGGGGJJJJJMMMM
DDDDDDDDDDDDDDDDDDDDGGDDDDDDDDDDDGGGGGGGGGJJJJJJMM
DDDDDDDDDDDDDDDDDDDDDDDDDDDDDDDDDDDGGGGGGGGJJJJJMM
DDDDDDDDDDDDDDDDDDDDDDDDDDDDDDDDDGDDGGGGGGGGJJJJMM
DDDDDDDDDDDDDDDDDDDDDDDDDDDDDDDDDGGGGGGGGGGGJJJJJM
GDDDDDDDDDDDDDDDDDDDDDDDDDDDDDDDDGDGGGGGGGGGGJJJJJ
GGGDDDDDDDDDDDDDDDDDDDDDDDDDDDDDDDDDDGGGGGGJJJJJJJ
GGGGGDDDDDDDDDDDDDDDDDDDDDDDDDDDDDDDDDDGGGGJJJJJJJ
JGGGGGGDDDDDDDDDDDDDDDDDDDDDDDDDDDDDDDDGGGJJJJJJJJ
JJGGGGGGDDDDDDDDDDDDDDDDDDDDDDDDDDDDDDDGGGJJJJJJJJ
JJJJJJGGGDDDDDDDDDDDDDDDDDDDDDDDDDDDDDDGGGJJJJJJJJ
JJJJJJGGGDDDDDDDDDDDDDDDDDDDDDDDDDDDDDDGGGJJJJJJJJ
JJJJJJJGGGDDDDDDDDDDDDDDDDDDDDDDDDDDDDDGGGJJJJJJJJ
JJJJJJJGGGGDDDDDDDDDDDDDDDDDDDDDDDDDDGGGGGJJJJJJJJ
JJJJJJJGGGGGGDDDDDDDDDDDDDDDDDDDDDDDDDGGGGJJJJJJJJ
JJJJJJJGGGGGGGDDDDDDDDDDDDDDDDDDDDDDDDGGGJJJJJJJJJ
JJJJGGGGGGGGGGDDDDDDDDDDDDDDDDDDDDDDDDGGGGJJJJJJJJ
JJJJJGGGGGGGGGDDDDDDDDDDDDDDDDDDDDDDDDGGGGJJJJJJJJ
JJJJGGGGGGGGGGDDDDDDDDDDDDDDDDDDDDDDDGGGGGGJJJJJJJ
JJJGGGGGGGGGGDDDDDDDDDDDDDDDDDDDDDDDDGGGJJJJJJJMJJ
JJGGGGGGGGGGGDDDDDDDDDDDDDDDDDDDDDDDDGGGJJJJJJMJJJ
GGGGGGGGGDDDDDDDDDDDDDDDDDDDDDDDDDDDGGGGJJJJJJMJMJ
GGGGGGGGGDDDDDDDDDDDDDDDDDDDDDDDGGDDGGJJJJJJJMMMJM
GGGGGGGGGDDDDDDDDDDDDDDDDDDDDDDDDDDGGGJJJJJJJMMMMM
GGGGGGGGGGDDDDDDDDDDDDDDGGGGGDDDDDGGGJJJJJJJJMMMMM
GGGGGGGGGGGDDDDDDDDDGDGGGGGGDDGDDDGGGGJJJJJMJMMMMM
GGGGGGGGGGGGDDDDDDGGGGGGGGGGGGGGGGGGGJJJJJJJMMMMMM
GGGDGGGGGGGGGGDGGGGGGGGGGGGGGGGGGGGGJJJJJJJJJJMMMM
GGDDGGGGGGGGGGGGGGGGGGGGGGGGJGGGGGJJJJJJJJMMMMJMMM
GDDDGGGGGGGGGGGGGGGGGGGGJJJJGGGGGJJJJJJJJMMMMMMMMP
DDDDDDGGGGGGGGGGGGGJJJJJJJJJJGGGGJJJJJJMMMMMMMMMMP
DDDDDDGGGGGGGGGGGGGJJJJJJJJJJJJGJJJJJJMMMMMMMMMPPP
AADDGDDGGGGGGGGGGGGJJJJJJJJJJJJJJJJJJJJMMPMMMPMPPP
AADDDDDDDGGGGGGGGGGJJJJJJJJJJJJJJJJJJJJMPPPMPPPPPP
AAADDDGDGGGGGGGGGGGJJJJJJJMMJMJJJJJJJJMMPPPPPPPPPP
AAADDDGGDGGGGGGGGGGJJJJJJJMMMMMJJMJMJMMPPMPPPPPPPP
AAAAADGDDDDDDDGGGGGGJJJJJJJMMMJMMMJMMMMMPPPPPPPPPM
AAAAADGGDDDDDDGGGGGGJJJJJJMMMMMMMMMMMMPPPPPPPPPPPP
AAAADGGGDDDDDDDDGGGGJJJJJMMMMMMMMMPMMJMPMMPPPPPPPP
AAAAAGGGDDDDDDDDGGGGJJJJJMMMMMPPPPMMMJMJMMMMMMMMMP
AAAAADGGDDDDDDDDGGGGJJJJJMMMMPPMMMPMJMJJMMMMJMMMMM
