AAAAAAAAAAAAAAAAAAAAAGGGGGGGGGGGGGJGJJJJJJJJJJJJJJ
AAAAAAAAAAAAAAAAAAAAAADGGGGGGGGGGGGGGGJJJJJJJJJJJJ
DAAAAAAAAAAAAAAAAAAAAADDGGGGGGGGGGGGGGJGGGJJJJJJJJ
DAAAAAAAAAAAAAAAAAAAAAADDGGGGGGGGGGGGGGGGGJJJJJJJJ
GDAAAAAAAAAAAAAAAAAAAAAADGGGGGGGDDGGGGGGGGGGJJJJJJ
GGGAAAAAAAAAAAAAAAAAAAAAADDDDDDDDADGGGGGGGGGGJJJJJ
JGGDAAAAAAAAAAAAAAAAAAAAAAAAAAAAAAADDDDDDGGGGGGJJJ
JGGGDAAAAAAAAAAAAAAAAAAAAAAAAAAAAAAAAAAADDDGGGGGJJ
GGGGGAAAAAAAAAAAAAAAAAAAAAAAAAAAAAAAAAAADDDGGGGGJJ
JGGGGDAAAAAAAAAAAAAAAAAAAAAAAAAAAAAAAAAADDGGGGGGJJ
GGGGGGAAAAAADAAAAAAAAAAAAAAAAAAAAAAAAAAADDGGGGGGJJ
JGGGGGDAAADAAAADAAAAAAAAAAAAAAAAAAAAAAAADDGGGGGGJJ
JJGGGGDDDDDDAAAAAAAAAAAAAAAAAAAAAAAAAAAAADGGGGGGGG
JJJGGGDDGDAAAAAAAAAAAAAAAAAAAAAAAAAAAAAAADGGGGGGGG
JJJGGGGGGGDAAAAAAAAAAAAAAAAAAAAAAAAAAAAAAADGGGGGGG
JJJJGGGGGGDAAAAAAAAAAAAAAAAAAAAAAAAAAAAAAAADGGGGGG
JJJJGGGGGGDADDDDDDDAAAAAAAAAAAAAAAAAAAAAAAAAADDGGG
JJJJGGGGGGDDDDGGDDGGDDDDAAAAAAAAAAAAAAAAAAAAAAADDD
JJJJJJJGGGGGDGGGGGGGGDGGDAAAAAAAAAAAAAAAAAAAAAAADD
JJJJJJJGGGGGGGGGGGGGGGGGGDAAAAAAAAAAAAAAAAAAAAAAAD
MJJJJJJJGGGGGGGGGGGGGGGGGGDAAAAAAAAAAAAAAAAAAAAAAA
MMJJJJJJGGGGGGGGGGGGGGGGGGDAAAAAAAAAAAAAAAAAAAAAAA
MJJJJJJJJJGGGGGGGGGGGGGGGGDAAAAAAAAAAAAAAAAAAAAAAA
JJJJJJJJJJJGGGGGJJJJGGGGGGAAAAAAAAAAAAAAAAAAAAAAAA
JJJJJJJJJJJJGJJJJJJJJGGGGGDAAAAAAAAAAAAAAAAAAAAAAA
MJJJJJJJJJJJJJJJJJJJJGGGGGDAAAAAAAAAAAAAAAAAAAAAAA
MMMJJJJJJJJJJJJJJJJJJJGGGGGDAAAAAAAAAAAAAAAAAAAAAA
JMMJJJJJJJJJJJJJJJJJJJJGGGGAAAAAAAAAAAAAAAAAAAAAAA
JJJJJJJJJJJJJJJJJJJJJJGGGGDAAAAAAAAAAAAAAAAAAAAAAA
JJJJJJJJJJJJJJJJJJJJJGGGGDAAAAAAAAAAAAAAAAAAAAAAAA
JJJJJJJJJJJJJJJJJJJJJGGGGAAAAAAAAAAAAAAAAAAAAAAAAA
JJJJJJJJJJJJJJJJJJJJJGGGDAAAAAAAAAAAAAAAAAAAAAAAAD
JJJJJJJJJJJJJJJJJJJJJJGGDAAAAAAAAAAAAAAAAAAAAAAADD
JJJJJJJJJJJJJJJJJJJJJJGGDAAAAAAAAAAAAAAAAAAAAAAADG
JJJJJJJJJJJJJJJJJJJJJGGGDAAAAAAAADDAAAAAAAAAAAADDD
MJJMMJJJJJJJJJJJJJJJJJGGDDDAAAAADDDDDDDAAAAAAAAAAA
JJJJJJJJJJJJJJJJJJJJJJJGGDDAAAADGGGGGGGDGGGGDDDDAA
JJJJJJJJJJJJJJJJJJJJJJJGGGGDAADGGGGGGGGGGGGGGGGGDD
JJJJJJJJJMMJJJJJJJJJJJJJGGGGDDGDGGGGGGGGGGGGGGGGGG
JJJJJJJJJJMMMMMJJJJJGGGGGGGGGGGGGGGGGGGGGGGGGGGGGG
JGJJJJJMJJMMMMMMJJJJJJGGGJGGGGGGGGGGGGGGGGGGGGJGGG
GGJJJJMMJMMMMMMMMJJJJJJJJJJJGGGGGGGGGGGGGGGGGJJJJG
GGJJJJJMMMMMMMMMMMJJJJJJJJJJJJGGGGGGGGGGGGJJJJJJJJ
JGJJJMJMMMMPMPPMMJJJJJJJJJJJJJGGGGGGGGGGJJJJJJJJJJ
GGJJJMMMJMMMMPMMMMJJJJJJJJJJJJJJJJGGGGGJJJJJJJJJJJ
JJJJJJJJMMMMMPPMMJJJJJJJJJJJJJJJJGGJGGGJJJJJJJJJJJ
JJJJJMJMMPMMPPPPMMJJJJJJJJJJJJJJJJJJJGGJJJJJJJJJJJ
GJJJJMMMMPPPPPPMMMJJJJJJJJJJJJJJJJJJJJGGJJJJJJJJJJ
GGJJMMMPPPPPPPMMMMJJJJJJJJJJJJJJJJJJJJJGGJJJJJJJJJ
JJJJMJMMPPPMMMMMMMJJJJJJJJJJJJJJJJJJJJJJJJJJJJJJJJ
