JJJJJJJJJJJJJJJJJJJJJJJJJJJJJJJJJJMMJJJMMPMPPPPPPP
JJJJJJJJJJJJJJJJJJJJJJJJJJJJJJJJJMMMJJJJMMMMMMPPPP
JJJJJJJJJJJJJJJJJJJJJJJJJJJJJJJJJMMMMJJJJJMMMMPPMM
JJJJJJJJJJJJJJJJJJJJJJJJJJJJJJJJJMMMJJJJJMJJMPPMJM
JJJJJJJJJJJJJJJJJJJJJJJJJJJJJJJJJMJJJJJJJJJMMMMMJM
JJJJJJJJJJJJJJGGGJJJJJJJJJJJJJJJJJJJMJJJMMMMJMJJMM
GGGJJJJJJJJJJJGGJJJJJJJJJJJJJJJJJJJMMJJJJMMMJMMPMJ
GGGGGGGGJJJJJGGJGJJJJJJJJJJJJJJJJJJJJJJJJJMJJJMPMJ
GGGGGGGGGJJGGGGGGJJJJJJJJJJJJJJJJJJJJJJJJJJJMMPPPM
GGGGGGGGGGGGGGGGGJJJJJJJJJJJJJJJJJJJJGJJJJJJMPPPPP
GGGGGGGGGGGGGGGGJJJJJJJJJJJJJJJJJJJJJJGJJJJJJMMPPP
GGGGGGGGGGGGGGGGJJJJJJJJJJJJJJJJJJJJJJJJJJJJMMMPPM
GGGGGGGGGDGGGGGGGJJJJJJJJJJJJJJJJJJJJJJJJJJJJMMMMM
GGGGDGGGDDDGGGGGGJJJJJJJJJJJJJJJJJJJJJJJJJJJJJJMJM
GDGDDDGDDDDGGGGGGGJJJJJJJJJJJJJJJJJJJJJJJJJJJJMMMM
GGDDDDDDDDDGGGGGGGJJJJJJJJJJJJJJJJJJJJJJJJJJJJJJJJ
GGDDDDDDDDGGGGGGGGJJJJJJJJJJJJJJJJJJJJJJJJJJJJJJJJ
GGGDDDDDDDGGGGGGGGJJJJJJJJJJJJJJJJMMJJJJJJJGGJJJJJ
DDGDDDAADDDGGGGGGGJJJJJJJJJJJJJJJJMMJJJJJJGGJJJJJJ
DADDAAAAADDDGGGGGJJJJJJJJJJJJJJJJMMJJJJJJJJJJJJJJJ
DDDDAAAAAAADGGGGGJJJJJJJJJJJJJJJJJJJJJJJJJJJJJJJJJ
DDAAAAAAAAADDDGGGJJJJJJJJJJJJJJJJJJJJJJJJJJJJJJJJJ
AAAAAAAAAAAAADGGGGJJJJJGJJJJJJJJJJJJJJJJJJJJJJMJMJ
AAAAAAAAAAAAADGGGGGGGGGGJJJJJJJJJJJJJJJJJJJJJJJJJJ
AAAAAAAAAAAAADGGGGGGGGGGGJJJJJJJJJJJJJJJJJJJJJJJJJ
AAAAAAAAAAAAADGGGGGGGGGGGGGGJJJJJJJJJJJJJJJJJJMJJJ
AAAAAAAAAAAAADGGGGGGGGGGGGGGGGGJJJJJJJJJJJJJJJJMMJ
AAAAAAAAAAAAAADDDDDDDDDGGGGGGGGJJJJJJJJJJJJJJJJMMM
DAAAAAAAAAAAAAAAAAAAAADGGGGGGGGJJJJJJJJJJJJJJJJMMM
DDAAAAAAAAAAAAAAAAAAAAADDGGGDGGGJJJJJJJJJJJJJJJJJJ
GDAAAAAAAAAAAAAAAAAAAAAADDDDDGGGJJJJJJJJJJJJJJJJJJ
GDAAAAAAAAAAAAAAAAAAAAAAADDDDGGGGJJJJJJJJJJJJJJJJJ
GDAAAAAAAAAAAAAAAAAAAAAAAAAADDGGGJJJJJJJJJJJJJJJJJ
GDAAAAAAAAAAAAAAAAAAAAAAAAAAADDGGGJJJJJJJJJJJJJJJJ
DDAAAAAAAAAAAAAAAAAAAAAAAAAAAAAGGGGJJJJJJJJJJJJJJJ
AAAAAAAAAAAAAAAAAAAAAAAAAAAAAAADGGGGJJJJJJJJJJJJJJ
DAAAAAAAAAAAAAAAAAAAAAAAAAAAADDGGGGGGJJJJJJJJJJJJJ
DAAAAAAAAAAAAAAAAAAAAAAAAAAAADGGGGGGGJJJJJJJJJJJJJ
AAAAAAAAAAAAAAAAAAAAAAAAAAAADDGGGGGGGJJJJJJJJJJJJJ
AAAAAAAAAAAAAAAAAAAAAAAAAAADDDGGGGGGJJJJJJJJMMMJMJ
AAAAAAAAAAAAAAAAAAAAAAAAAAADDGGGGJJGJJJJJJMMMMMMMM
AAAAAAAAAAAAAAAAAAAAAAAAAAADGGGGGJJJJJJJJMMMMMMMMM
AAAAAAAAAAAAAAAAAAAAAAAAAADGGGGJJJJJJJJJJJMMMPPPMM
AAAAAAAAAAAAAAAAAAAAAAAAAADGGGJJJJJJJJJJJMMMMPPPMM
AAAAAAAAAAAAAAAAAAAAAAAAAAGGGGJJJJJJJJMMJMMMMPPPMM
AAAAAAAAAAAAAAAAAAAAAADDDDGGGJJJJJJJJJJJJJMMMMPPMM
AAAAAAAAAAAAAAAAAAAAADGGGGGGGJJJJJJJJJJJJJMMMMPPMM
AAAAAAAAAAAAAAAAAAAAADGGGGGJJJJJJJJJJJJJJJMMMMMMMJ
AAAAAAAAAAAAAAAAAAAADGGGGGGJJJJJJJMMMJMJJJMJMMMMMM
AAAAAAAAAAAAAAAAAAAGGGGGGGGJJJMMMMMMMMMJJMMMMMMPMM
