JMMJJJJJJGGGGGGGGGGDDDAAAADADDDDGGGGGGGGGGGGGJJJJJ
JJJJJJJJJGGGGGGGGGGDDDDAAAAAAADDGGGGGGGGGGGGGGJJJJ
JJJJJJJJJGGGGGGGGGGGDDAAAAAAAAADGGGGGGGGGGGGGGGGJG
JJJJJJJGGGGGGGGGGGGGGGDAAAAAAAAAADDDGGDDDDGGGGGGGG
JJJJJGGGGGGGGGGGGGGGGGDAAAAAAAAAAAADADAAAAADGGGGGG
JJGGGGGGGGGGGGGGGGGGGGDAAAAAAAAAAAAAAAAAAAAADGGGGG
JGGGGGGGGGGGGGGGGGGGGGGDAAAAAAAAAAAAAAAAAAAAADDDGG
GGGGGGGGGGGGGGGGGGGGGGGDAAAAAAAAAAAAAAAAAAAAADDDGD
GGGGGGGJJJJGGJGGGGGGGGGGAAAAAAAADAAAAAAAAAAAAADDDD
GGGGGJJJJJJJJJGGGGGGDGGGDDAAAAADDDAAAAAAAAAAAADAAA
GGGGGJJJJJJJJJGGGGGGDDGDDAAAAAAAAAAAAAAAAAAAAAAAAA
GGGGJJJJJJJJJJJGGGGGDDGDAAAAAAAAAAAAAAAAAAAAAAAAAA
GGGJGGGJJJJJJJJGGGGGDDDDAAAAAAAAAAAAAAAAAAAAAAAAAA
GGGGJGGJJJJJJJJGGGGGGDDDAAAAAAAAAAAAAAAAAAAAAAAAAA
GGGGGJJJJJJJJJGGGGGGDAAAAAAAAAAAAAAAAAAAAAAAAAAAAA
GGGGGJJJJJJJGGGGGGGDADDAAAAAAAAAAAAAAAAAAAAAAAAAAA
GGGGGGGGJJJJJGGGGGGGDDDDAAAAADDAAAAAAAAAAAAAAAAAAA
GGGGGGGJJJJJJJGGGGGGDDDDDAAAAAAAAAAAAAAAAAAAAAAAAA
GGGGGGGJJJJJJJGGGGGGGGGGDAAAAAAAADAAAAAAAAAAAAAAAA
GGGGGGJJJJJJJJGGGGGGGGGDDDDAAAAAAAAAAAAAAAAAAAAAAA
GGGGGGJJJJJJJJGJJJGGGGGGGGGDAAAAAAAAAAAAAAAAAAAAAA
GJJJJGJJJJJJJJGJJJGJGGGGGGGDDAAAAAAAAAAAAAAAAAAAAA
JJJJJJGGJGGGJGGJJJJJGGGGGGGGDAAAAAAAAAAAAAAAAAAAAA
JJJJJJJGGGGGGGGJJJJJJGGGGGGGDAAAAAAAAAAAAAAAAAAAAA
JJJJJJGGGGGGGGGJJJGJJJJJGGGGGDDDAAAAAAAAAAAAAAAAAA
JJJJJJGGGGGGJJGGGGGJJJJJGGGGGGGDAAAAAAAAAAAAAAAAAA
JJJJJJJGGGGGJJJJJJJGJJJJJGGGGGGGDDDDDAAAAAAAAAAAAA
JJJJJJJJGGGGJJJJJJJJJJJJJJGJGGGGGGGGDDAAAAAAAAAAAA
JJJJMJJJJJJJJJJJJJJJJJJJJJJJGGGGGGGGGGDAAAAAAAAAAA
JJJJJJJJJJJJJJJJJJJJJJJJJJJJJGGGGGGGGGGDAAAAAAAAAA
JJJJJJJJJJJJJJJJJJJJJJJJJJJJJJGJJGGGGGGDAAAAAAAAAA
JJJJJJMJJJJJJJJJJJJJJJJJJJJJJJJJJGGGGGGAAAAAAAAAAA
JJMJJJJJJJJJJJJJJJJJJJJJJJJJJJJJJJGGGGGAAAAAAAAAAA
JJMJJJJJJJJJJJJJJJJJJJJJJJJJJJJJJJGGGGGGDDDDDAAAAA
JMMJJJJJJJJJJJJJJJJJJJJJJJJJJJJJJJJGGGGGDAAAAAAAAD
JMJJJJJJJJJJJJJJJJJJJJJJJJJJJJJJJJJGGGGGDAAAAAAAAD
JJJJJJJMJJJJJJJJJJJJJJJJJJJJJJJJJJJGGGGGDAAAAAAAAD
JJJJJJJMJJJJJJJJJJJJJJJJJJJJJJJJJJJGGGGGGAADAAADAD
JMMJMMJMJJJJJJJJJJJJMJJJJJJJJJJJJJJGGGGGGGGGDADDDD
MMJJJJJJJJJJJJJJJJJJMMJJMMMJJJJJJGGGGGGGGGGGGGDGDG
MMJJJJJJJJJJJJJJJJJJMMMMMMMJJJJJJJGGGGGGGGGGGGGGDD
MMMJJJJJJJJJJJJJJJJMMMMMMMMJJJJGGGGGGGGGGGGGGGGGGG
MMMJJJJJJJGJJJJJJJMJJMMMMMMMJJJJJGGGGGGJGGGGGGGGGG
MMMJJJJJJJJJJMJJJMMMJMMPMMMMMJJJJJJJJGJJJJJGGGGGGG
MMMMJJJJJJJMMMMMMMMJMJMMMMMMMMJJJJJJJJJJJGGGGGGGGG
MMMMJMJJJJMMMMMPMMMMJMJMMMMMMMJJJJJJJJJJJGGGGGGGGG
MMMMMJJJJJMMMPPPMPMJMJMMMMJMMMMMJJJJJJJJJGGJGGGGGG
MMMMMMMMPPMMPMPPPPMJMMMJJMMMMMMMMJJJJJJJGGGGJJJJJJ
MMMMPPMPPMMPPPPPMJMMMMJJJJMMMMMMMMMJJJJGGGGGJJJJJJ
MMMMPPPPMPPPPPPMMMMMMMMMMJJMMMMMMJJJJJJGGGJGJJJJJJ
