AAAAAAAAAAAAAAAAADDDGDDDGGGGGGGGGGGGGGGGGGGJJJJJJJ
AAAAAAAAAAAAAAAAAAAAAADADDDDGGGGGGGGGGGGGGGGGJJJJJ
AAAAAAAAAAAAAAAAAAAAAAAAAADDDDGGGGGGGGGGGGGGGGJJJJ
AAAAAAAAAAAAAAAAAAAAAAAAAADDDDDDDDDDDGGGGGGGGGJJJJ
AAAAAAAAAAAAAAAAAAAAAAAAAADDDDDAAAAADDGGGGGGGGGJJJ
AAAAAAAAAAAAAAAAAAAAAAAAAADDAAAAAAAADDGGGGGGGGGGJJ
AAAAAAAAAAAAAAAAAAAAAAAAAADAAAAAAAAAADDDDDDGGGGGGJ
AAAAAAAAAAAAAAAAAAAAAAAAAAAAAAAAAAAAAAAADDDDGGGGJJ
AAAAAAAAAAAAAAAAAAAAAAAAADAAAAAAAAAAAAAAAADDGGGGJJ
AAAAAAAAAAAAAAAAAAAAAAAAADAAAAAAAAAAAAAAAAAADGGGGJ
AAAAAAAAAAAAAAAAAAAAAAAAAAAAAAAAAAAAAAAAAAAAAGGGGJ
AAAAAAAAAAAAAAAAAAAAAAAAAAAAAAAAAAAAAAAAAAAADGGGGG
AAAAAAAAAAAAAAAAAAAAAAAAAAAAAAAAAAAAAAAAAADDDGGGGG
AAAAAAAAAAAAAADDDAAAAAAAAAAAAAAAAAAAADDDDGDDDGGGGG
AAAAAAAAAAADDDDGGDDAAAAAAAAAAAAAAAAAAADGGGGGGGGGGG
AAAAAAAAAADDGGGGGDDDAAAAAAAAAAAAAAAAAADGGGGGGGGGGG
AAAAAAAAAADDGGGGGGGDDAAAAAAAAAAAADDDDDGGGGGGGGGGGG
AAAAAAAAAAADGGGGGGGGGDAAAAAAAAAADGGDDDGGGGGGGGGGGG
AAAAAAAAAAAADGGGGGGGGGDAAAAAAADDGGGGGGGGGGJJJJJJJJ
AAAAAAAAAAAADGGGGGGGGGGDAAAAADGGGGGGGGGGGJJJJJJJJJ
AAAAAAAAAAAADGGGGGGGGGGGDDDDDGGGGGGGGGGGJJJJJJJJJJ
AAAAAAAAAAAADGGGGGGGGGGGGGGGGGGGGGGGGGGJJJJJJJJJJJ
AAAAAAAAAAAADGGGGGGGGGGGGGGGGGGGGGGGGGGJJJJJJJJJJJ
AAAAAAAAAAAADGGGGGGGGGGGGGGGGGGGGGGGGGGGJJJJJJMMMJ
AAAAAAAAAAADGGGGGGJJGGGJJJJGGGGGGGGGGJJJJJJJJMMJJM
AAAAAAAADDDGGGGJJJJJJGJJJJJJJJJGGGJJJJJJJJJJJMJJJJ
DDDAAAADGGGGGGGJJJJJJJJJJJJJJJJGGJJJJJJJJJMJJJJJJJ
GGGDDDGGGGGGGGGJJJJJJJJJJJJJJJJJJJJJJJJJJJJMJJJJJJ
GGGGDGGGGGGGGGJJJJJJJJJJJJJJJJJJJJJJJJJJJMMMMJJJJJ
GGGGGGGGGGGGGGJJJJJJJJJJJJJJJJJJJJJJJJJJJJMMJJJJJJ
GGGGGGGGGGGGGGGGJJJJJJJJJJJJJJJJJJJJJJJJJJJJJJJJJJ
GGGGGGGGGGGGGGGGGGJJJJJJJJJJJJJJJJJJJJJJJJJJJJJJJJ
GGGGGGGGGGGGGGGGGGJJJJJGGGJJJJJJJJJJGGJJJJJJJJJJMJ
GGGGGGGGGGGGGGGGGGJJJJJGGGGGGJJJJJJJJGJJJJJJJJJMMJ
GGGGGGGGGGGGGGGGGGJGGGGJJGGGGJJJJJJJJJJGJJJJJJJJJJ
GGGGGGGGGGGGGGGGGGJGGJJJJGGGGGJJJJJJJJJJJJJJJJJJJJ
GJGGGGGGGGGGGGGGGGJGGGJJGGGGJJJJJJJJJJJJJJJJJJJJJG
GJGGGGJJJGGGGGGGGGGGJJJJGGGGGJJJJJJJJJJJJJJJJJJJJJ
GJJGJJJJJGGGGGGGGGGJJJJJJJJJJJJJJJJGJJJJJJJJJJJJJJ
JJJJJJJJJGGGGGGGGGJJJJJJJJJJJJJJJJJGJJJJJJJJJJJJJJ
JJJJJJJJJGGJGJJGGGJJJJJJJJJJJJJJJJJJJJJJJJJJMJJJJJ
JJJJJJJJJJJJJJJGJGJJJJJJJJJJJJJJJJJJJJJJJJJJJMJMMJ
JJJJJJJJJJJJJJJJJJJJJJJJMJJJJJJJJJJJJJJJMJJJMMMMMM
JJJJJJJJJJJJJJJJJJJJJJJJJJJMMJJJJJJJJMMMMMMMMMMMMM
JJJJJJJJJJJJJJJJJJJJJJJJJJJJJJJJMJJJJJMMMJJMMMMMMM
JJJJJJJJJJJJJJJJJJJJJJMJJMJJJJJJMMJMMJMMMMJJMJMMMM
JJJJJJJJJJJJJJJJJJJJMMMMJMMJJJJJMJMMMMMMMMMMJJMMMM
JJJJJJJJJJJJJJJJJJJJMMMMMMJMMMMMJMJJMMMMMMMMMMMMMM
JJJJJJJJJJJJJJJJJJMMMMMMMJMMMMMPMMJMMJJMMMMPPMMMPP
JJJJJJJJJJJJJJJJJJMMMPMMMMMMPPPPMMMMMMMMMMMPPPPPPP
