GGGGGGGGGGGGGGAAAAAAAAAAADGGDDGDGGGGGJJJJJJJJJJJMM
GGGGGGGGGGDDDAAAAAAAAAAAADGDDDDDDDGGGJJJJJJJJJJJJM
GGGGGGGGDDDAAAAAAAAAAAAAAAAAADDDDGGGJJJJJJJJJJJJMM
GDGDDDDDAAAAAAAAAAAAAADDDDDAADDDDGGGJJJJJJJJJJJMMM
DADAAAAAAAAAAAAAAAAAADDGGGDDDAADDDGGJJJJJJJJJJMMMM
AAAAAAAAAAAAAAAAAAAAADDGGDDDDDDGGGGJJJJJJJJJJJJJMJ
AAAAAAAAAAAAAAAAAAAAAADDGGGGGDGGGGGJJJJJJJJJJMJJJJ
AAAAAAAAAAAAAAAAAAAAAADGGGGGGGGGGGJJJJJJJJJJJJJJJM
AAAAAAAAAAAAAAAAAAAAADGGGGGGGGGGGJJJJJJJJJJJJJMMJM
AAAAAAAAAAAAAAAAAAAADGGGGGGGGGGJJJJJJJJJJJJJJJJMJM
AAAAAAAAAAAAAAAAAAAADGGGGGGJJJJJJJJJJJJJJJJJJMMMJM
AAAAAAAAAAAAAAAAAAADGGGGGGGJJJJJJJJJJJJJJJJJJMMMMM
AAAAAAAAAAAAAAAAAAAGGGGGGGGJJJJJJJJJJJJJJJMMMMMJMM
AAAAAAAAAAAAAAAAAADGGGGGGGGJJJJJJJJJJJJJJJMMMMMMMJ
AAAAAAAAAAAAAAAAAADGGGGGGGGJJJJJJJJJJJJJMMMJMMMMJM
AAAAAAAAAAAAADAAAADGGGGGGGGGJJJJJJJJJJJJJMJMMMPMMM
AAAAAAAAAAAAAAADADDGGGGGGGGJJJJJJJJJJJJJJJJJMMMPMM
AAAAAAAAAAAAAAAAAAADGGGGGGGJJJJJJJJJJJJJJJJJMMPMMM
AAAAAAAAAAAAAAAAAAAADGGGGGJJJJJJJJJJJJJJMMMMMPPMMM
AAAAAAAAAAAAADAAAAAADGGGGGJJJJJJJJJJJJJJJMMMMMMMMM
AAAAAAAAAAAADDDDDDDDDGGGGGGJJJJJJJJJJJJJJMMMMMMMMJ
AAAAAAAAAAADDGGDDGGGGGGGGGGJJJJJJJJJJJJJJJMMMMJJJJ
DDDDAAAAAADDGGGGGGGGGGGGGGGGGJJJJJJJJJJJJJMMMMJJJJ
AAAADDAAAADGGGGGGGGGGGGGGGGGGJJJJJJMMMMJJJJJJJMJJJ
AAAAAAAAADDGGGGGGGGGGGJJJJGGGJJJJJJJMJJJJJJJJJJJJJ
AAAAADAAAADGGGGGGGGGGJJJJJJJGJJJJMMJMMMMJJJJJJJJJJ
AAAAADDAAADGGGGGGGGGGJJJJJJJJJJJJMJMJMMMJJJJJJJJMJ
AAAAADAAAADDGGGGGGGGGGGJJJJJJJJJJJJJJMJMMJJMJJJJJJ
AAAAAAAAADDGGGGGGGGJJGJJJJJJJJJJJMJJJMMMMMMMMJJJJJ
AAAAAAAAAAADDDDDGGGJJJJJJJJJJJJJJMMMMMMMMMMMJJJJJJ
AAAAAAAAAAADDDDDGGGJJJJJJJJJJJJJJMMMMPMMMMJJJJJMJJ
AAAAAAAAAAAADDDDGGGJJJJJJJJJJJJJJMMMPPPPMMJJMMJJJJ
AAAAAAAAADDDDGGGGGJJJJJJJJMJJJMMMMMMPPPPMMMMJMMJJJ
AAAAAAAADDDDDDGGGGGJJJJJJJMMJMMJMMMMPPPPMMMMMJJJJJ
AAAAAAAAADDDDDGGGGGJJJJJJJMMMMMMJMMMMMMMMMMMJJJMJJ
AAAAAADDDDDDDDGGGGGJJJJJJJMMMMMMMMMMMMMPMMMMJJJJJJ
AAAADDDDDDGGGGGGGGGJJJJJJJMMMMMMMMJMMMMPMMMMJJJJJJ
AAAADGGGGGGGGGGGGGGJJJJJJJJMMMMMMMMMJMMMMMMMJJJJJJ
AADGGGGGGGGGGGGGGGGGGGJJJJJJJMMMMMJJMMMMMMMMMJJJJJ
AADGGGGGGGGGGGGGGGGGGJJJJJJJJJMMMMMMMMMMMMMMMMJJJJ
ADDGGGGGGGGGGGGGGGGGJJJJJJJJJJJMMPMMMMMMMMMPPMJMJJ
DGGGGGGGGGGGGGGGGGGGGJJJJJJJJJJMMMPMMMMMMPPPMMMMMJ
GGGGGGGGGGGGGGGGGGGGGJJGJJJJJJJMMMPPPPPPPPPPMMMMJJ
GGGGGGGGGGGGGGGGGGGGJJJJJJJJJJMMJMPPPPPPPPPPPPMMMJ
GGGGGJJJJJJJJGGGJJJJJJJJJJJJJMMMMMPPPPPPPPPPMMMMMJ
GGGGGJJJJJJJJGJGJJJJJJJJJJJJMMMMMMMPMPPPMMPMMJMMJJ
GGGGGJJJJJJJJJJJJJJJJJJJJJJMJMMMMMMMMPPPMMMMMJMJJJ
GGGGGGJJJJJJJJJJJJJJJJMJJJMMMMMMMPMPPPPPMMMMJJJJJJ
GGGGGGJJJJJJJJJJJJJJJJJJJMMMMMMMPPPPPPPMPMMJJJJJJJ
GGGGJJJJJJJJJJJJJJJJJJJJJJMMMMMMPPPPPPMMMMMMJJMMMM
