JJJJJJJJJJJJJJJJJJGGGGDDDDDDDDDDDAAADDDAAAAAAAAAAA
JJMJMJJJJJJJJJJJJGGGGGDDDDDDGDDDDAAAAAAAAAAAAAAAAA
JMJMJJJJJJJJJJJJJJGGGGGGGGDDGGGDDAAAAAAAAAAAAAAAAA
MMMMJJJJJJJJJJJJJJJGGGGGGGDDGGGDDDAAAAAAAAAAAAAAAA
MMMMJJJJJJJJJJJJJJJGGGGGGGGGGGGDAAAAAAAAAAAAAAAAAA
MMMMJJJJJJJJJJJJJJJGGGGGGGGGGGGDAAAAAAAAAAAAAAAAAA
MMMMMJJJJJJGJJJJJJJGGGGGGGGGGGGDDAAAAAAAAAAAAAAAAA
PPMMMJJJJJJJJJJJJJJJGGGGGGGGGGDDAAAAAAAAAAAAAAAAAA
MMPMMJJJJJJJJJJJJJJJJJGGGGGDDDDAAAAAAAAAAAAAAAAAAA
MMMMMMMMJJJJJJJJJJJJJJJGGGGGDDAAAAAAAAAAAAAAAAAAAA
PPMMMJJMJJJJJJJJJJJJGJGGGGGGDDAAAAAAAAAAAAAAAAAAAA
MMMMMJJMJJJJJJJJJJJJGGGGGGGGGDDAAAAAAAAAAAAAAAAAAA
PPMMMMMMJJJJJJJJJJJJGGGGGGGDGDAAAAAAAAAAAAAAAAAAAA
PPPMPMMMJJJJJJJJJJGJGGGGGGGDGDAAAAAAAAAAAAAAAAAAAA
PPPMMMMMJMJJJJJJJJGGGGGGGGDDDDAAAAAAAAAAAAAAAAAAAA
PPPPMMMMMJMJJJJJJJJJGGGGGGGGGDAAAAAAAAAAAAAAAAAAAA
PPPPPMMMMMMMJJJJJJJJGGGGGGGGGAAAAAAAAAAAAAAAAAAAAA
PPPPPPPMMMMMMJJJJJJJJGGGGGGGGAAAAAAAAAAAAAAAAAAAAA
PPPPPMMMMMMJJJJJJJJJJGGGGGGGGAADDAAAAAAAAAAAAAAAAA
PPPPPPPMMJJJJJJJJJJJJJJJGGGGGGGDDDAAAAAAAAAAAAAAAD
PPMPPMMMMJJJJJJJJJJJJJJJGGGGGGGGGDGDAAAAAAAAAADDDG
PPMMMMJMJJJJJJJJJJJJJJGGGGGGGGGGGGGGGDDAAAAAAADGGG
PMMMMMJJJJJJJJJJJJJJJGGGJGGGGGGGGGGGGDDAAAADADDGGG
MMMMMMMJJJJJJJJJJJJJJJJJGGGGGGGGGGGGGGDDDDDDDDGGGG
MMMMMMMJJJJJJJJJJJJJJJJJGGGGGGGGGGGGGGGGGGGGGGGGGG
MMMMMMMJJJJJJJJJJJJJJJJJGGGGGGGGGGGGGGGGGGGGGGGGGG
MMMMPPMJJJJJJJJJJJJJJGJGGGGGGGGGGGGGGGGGGGGGGGGGGG
PMMMMMMJJJJJJJJJGGGGGGGGGGGGGGGGGGGGGGGGGGGGGGGGGG
PMMMMMMJJJJJJJJGGGGGGGGGGGGGGGGGGGGGGGGGGGGGGGGGGG
PPPMMMJJJJJJJJJGGGGGGGGGGGGGGGGGGGGGGGGGGGGGGGGGGG
MMMMMMMJJJGGGGGGGGGGGGGGGGGGGGGGGGGGGGGGGGGGGGGGGG
JMMMMMMJJJGGGGGGGGGGGGGGGGGGGGGGGGGGJGGGGGGGGGGGGG
JJMJMMMJJGGGGGGGGGGGGGGGGGGGGGGGGGGGGJGGGGGGGGGGGG
MMJJJMJJJJGGGGGGGGGGGGGGGGGGGGGGGGGGGGGGGGGGGGGGGG
MMJJJJJJGGGGGGGGGGGGGGGGGGGGGGGGGGGGGGGGGGGGGGGGGG
MMJJJJJJJGGGJJJGGGGGGGGGGGGGGGGGGGGGGGGGGGGGGGGGGG
MMJMJJJJJJGJJJJJJJGGGGGGGGGGGGGGGGGGGGGGGGGGGGGGGG
JJMJMJJJJJJJJJJJJJJJGGGJJGGGGGGGGGGGGGGGGGGGGGGGGG
JJJJJMJJJJJJJJJJJJJJJJJJJGGJGGGGGGGGGGGGGGGGGGGGGG
JJJJJJJJJJJJJJJJJJJJJJJJGGGGGGGJGGGGGGGGGGGGGGGGGG
JGJJMJJJJJJJJJJJJJJJJJJJJGGGJJJGGGGJJJGGGGGGGGGGGG
JJJJJJJJJJJJJJJJJJJJJJJGGGGGGJJGGGJJJJJGGGGGGGGGGG
JJJJJJJJJJJJJMJJJJJJJJJGGGGGGJJJJJJJJJJGGGGGGGGGGG
JJJJJJJMMMJJMMMJJJJJJJJGGGGGGJJJJJJJJJJJJGGGGGGGGG
JJJMJJMMMMJMMMMMJJJJJJJJJGGGGJJJJJJJJJJJJGGGGGGGGG
MJJMMJMMMMMMMMMJJJJJJJJJJJGGGJJJJJJJJJJJJJGGGGGGGG
JJJJMJMMPPPMMMMMMMMJJJJJJJJJJJJJJJJJJJJJJJGGGGGGGG
JJMMMJMMPPPPMMMMMMMJJJJJJJJJJJJJJJJJJJJJJJGGGGGGGG
MJMMMJMMMPPPPMMMMJMMJJJJJJJJJJJJJJJJJJJJJJJJGGGGGG
MMMJJJJMMMPPPPMMMMJJJJJJJJJJJJJJJJJJJJJJJJJJJGGGGG
