GGJJJJGJJJJGGGGDAAAADDDGDDDDDAAAAAAAAAAAAAAAAAAAAA
GGGGGGGJJJJGGGGDDAAADDGGDDDDAAAAAAAAAAAAAAAAAAAAAA
JGGGGGGGJJJGGGGGDDAADDDDDAAAAAAAAAAAAAAAAAAAAAAAAA
GGGGGGGGGJJJJGGGGDAADDDAAAAAAAAAAAAAAAAAAAAAAAAAAA
GGGGGGGGGGJJJGGGGDAAAAAAAAAAAAAAAAAAAAAAAAAAAAAAAA
JGGGGGGGGGGGGGGGGGDDAAAAAAAAAAAAAAAAAAAAAAAAAAAAAA
JJGGGGGGGGGGGGGGGGGGAAAAAAAAAAAAAAAAAAAAAAAAAAAAAA
JJJGGGGJGGGGGGGGGGGGAAAAAAAAAAAAAAAAAAAAAAAAAAAAAA
JJJGJJJJJGGGGGGGGGGGAAAAAAAAAAADDDAAAAAAAAAAAAAAAA
JJJJJJJJJGGGGGGGGGGGDAAAADDDDDDGGGAAAAAAAAAAAAAAAA
JJJJJJJJGGGJGGGGGGGGDGDAGGDGGGGGGGGDDAAAAAAAAAAAAA
JJJJJJJJJJJGGGGGGGDDDGGDGGGGGGGGGGGDDAAAAAAAAAAAAA
MJMMJJJJJJJGGGGGGGDDDDGGGGGGGGGGGGGDDDAAAAAAAAAAAA
MMMMJJJJJJJGGGGGGGGDGGGGGGGGGGGGGGGGDDAAAAAAAAAAAA
MMMMMJJJJJJJJGGGGGGGGGGGGGGGGGGGGGGGDDAAAAAAAAAAAA
MMPMMJJJJJJJJJJGGGGGGGGGGGGGGGGGGGGGGGDDAAAAAAAAAA
MPPMMMJJJJMJJJJJJGGGGGGGGGGGGGJJJGGGGGGGDAAAAAAAAA
MMMJMJJJMMJMJJJJJGGGGGGGGGGGGGJJJJJGGGGGGAAAAAAAAA
PPMMMJMMJJJJJJJJJJGGGJJGGGGJJJJJJJJJGGGGGDAAAAAAAD
PMMMMJJMJJJJJJJJJJJJJJJJGGGJJJJJJJJJGGGGGDAAAAAAAD
PMMMMJJJJJJJJJJJJJJJJJJGGGJGJJJJJJJJGGGGGDAAAAADDG
PPMMMJJJJJJJJJJJJJJJJJJGGJJJJJJJJJJJJGGGGDDDDADDGG
MJMJJJMJJJJJMJJJJJJJJJJJJJJJJJJJJJJJJJGGGGGDGGGGGG
MJJMMMMMMMMMMJJJJJJJJJJJJJJJJJJJJJJJJJJGGGGGGGGGGG
JJMMMMMMMMJJJJMJJJJJJJJJJJJJJJJJJJJJJJJJGGGGGGGGGG
JJPMMMMJJMJJMMMJJJJJJJJJJJJJJJJJJJJJJJJJJJJJGGGGGG
MMPMPMMJJJJMMMJJJJJJJJJJJJJJJJJJJJJJJJJJJJJJJJGGGG
JPPPPMMMMJJJMMJJJJJJJJJJJJJJJJJJJJJJJJJJJJJJJJGGGG
MPMPPPPPMMJMJJJJJJJJJJJJJJJJJJJJJJJJJJJJJJJJJJGGGG
MMPPPPPPPMMMMJJJJJJJJJJJJJJJJJJJJJJJJJJJJJJJJJGGGG
MMPPPPPPPPMMMJJJJJJJJJJJJJJJJJJJJJJJJJJJJJJJJJGGGG
MPPPPPPPPMMMJJJJJJJMJJJJJJJJJJJJJJJJJJJJJJJJJJGGGG
MMMPPPPPPMJJJJJJJJJMJJJJJJJJJJJJJJJJJJJJJJJJJJJGGG
MMPPPPPPPMJMMMMMMJJMJJJJJJJJJJJMJJMJJJJJJJJJJJJGGJ
MMMPPPPPPMJMMMMMJMJMMJJJJJJJMJMMJMMJJJJJJJJJJJJJJJ
MMMPPPPPPMMMPPPMMMMMMMJMMMMMMMMMMMMJJJJJJJJJJJJJJJ
JMMPPPPPPMMMPPPPPMMMMJMMMMMMPPMMMMJJJJJJJJJJJJJJJJ
MMMMPPPPMJMMPPPPPPMMMMMMPMPMPMMMJMJMJJJJJJJJJJJJJJ
MMMMPPPPMMJMMPPMPPPMMPPMPMPPPMMMJJMJJJJJJJJJJJJJJJ
MMMPPPMMPPPMMPPPPPPPPPPPPPPPPMMMMMMJJJJJJJJJJJJJJJ
JMMPPPPPPPMMPMMPMPPPPPMPPPPPMPMPMMMJJJJJJJJJJJJJJJ
JMPPPPPPPPMJMMMMMPPMMMJMMMMPMPMMPMMMJJJJJJJJJJJJJJ
JMMPPPPPPPPPMJMMMJMMMMMMMPMMMPMMMMMMMMMJJJJJJJJJJJ
MPMPPPPPPMPMMJMPMMMPPPPMPPPMPPPPMPMMMMJJJJJJJJJJJJ
PPPPPPMPPMMMMMPPMPPPPPPPPPPPPPPPPPMMMMMJJJJJJJJJJJ
MPPPMMMPPMMMMMMPPPPPPPMPPPPPPPPMPPPPPPMMMMJJJJJJJJ
PMPPPMPPPPMPPMPPPPPPPMMMJMMMMMMMMPPPPPMMMMJJJJJJJJ
PMPPPPMMPPPMPMMMPPPPMMMPMJMMJMJMMPPPPPMMMMMJJJJJJJ
MMPMPPMPMMMPPPPPPPPMMMJJJMJJJJMMPPPPPMPMMMJJJJJJJJ
MMMPPMMMPJMPPPMPPPMMMMJJJMJMJJMPMPPPPMMMMJJJJJJJJJ
