JJJJJJJJJJJJJJJJJJJJJJJJJJJJJJJJJJJJJJGGGGGGJJJJJG
JJJJJJJJJJJJJJJJJJJJJJJJJJJJJJJJJJJJJJGGGGGGGGJGGG
JJJJJJJJJJJJJJJJJJJJJJJJJJJJJJJJJJJJJJGGGGGGGGGGGG
JJJJJJJJJJJJJJJJJJJJJJJJJJJJJJJJJJJJJJJGGGGGGGGGGG
JJJJJJJJJJJJJJJJJJJJJJJJJJJJJJJJJJJJJJJJGGGGJJJJJJ
JJJJJJJJJJJJJJJJJJJJJJJJJMJJJJJJJJJJJJJGGGGGJJJJJJ
JJJJJJJJJJJJJJJJJJJJJJJJJJJJJJJJJJJJJJJJJJJJJJJJJJ
JJJJJJJJJJJJJJJJJJJJJJJJJJJJJJJJJJJJJJJJJJJJJJJJJJ
JJJJJJJJJJJJJJJJJJJJJJJJJJJJJJJJJJJJJMMJJJJJJJJJJJ
JJGGGJJJJJJGJGGJJJJJJJJJJJJJJJJJJJJJMMMJJJJJJJJJJJ
GGGGJJJJJJGGGGGGJJJJJJJJJJJJJJJJJJJJJMJJJJJJJJJJJJ
GGGJJJJJGGGGGGGGJJJJJJJJJJJJJJJJJJJJJMJJJJJMJJJJJJ
GGGJJJJGGGGGGGGJJJJJJJJJJJJJJJJJJJJJJJJJJMMJJJJJJJ
JJGGJJGGGGGGGGJJJJJJJJJJJJJJJJJJJJJJJJMJMMMMJJJJJJ
JJJGJGGGGGGGGJJJJJJJJJJJJJJJJJJJJJJJJJMMMMMJJJJJJJ
JJJGGGGGGGGGJJJJJJJJJJJJJJJJJJJJJJJJJJJJMMMJJJJJJG
JJJJGGGGGGGGGJJJJJJJJJJJJJJJJJJJJJJJJJJJJMJJJJJJGG
GGGGGGGGGDGGGGJJJJJJJJJJJJJJJJJJJJJJJJJJJJJJJJJJJG
GGGGGGGGDDDGGGJGJJJJJJJJJJJJJJJJJJJJJJJJJJJJJJJJJG
GGGGGGGDDDGGGGGGGJJJJJJJJJJJJJJJJJJJJJJJJJJJJJJJJG
GGGGGGGDADDDGGGGGJJJJJJJJJJJJJJJJJJJJGGJJJJJJJJJGG
GGGGGGDAAAAAAGGGGGJJJJJJJJJGGGGGJGJJJGGGJJJJJJJJGG
GGGGDDAAAAAAAADGGGGGJJGGGGGGGGGGGGGGGGGGGJJJJJJJGG
GDDAAAAAAAAAAAADGGGGJGGGGGGGGGGGGGGGGGGGGJGJJJJJGG
GDAAAAAAAAAAAAADGGGGGGGGGGGGGGGGGGGGGGGGGGGJJJJJGG
GDAAAAAAAAAAAAAADGGGGGGGGGGGGGGGGGGGGGGJGGGGGGGGGG
DAAAAAAAAAAAAAAADDDDGGGGGGGGGGGGGGGGGGGJGGGGGGGGGG
DAAAAAAAAAAAAAAAAAAADDDGGGGGGGGGGGGGGGGGGGGGGGGGGG
AAAAAAAAAAAAAAAAAAAAAADDGGGGGGGGGGGGGGGGGGGGGGGGGG
AAAAAAAAAAAAAAAAAAAAAADGGGGGGGGGGGGGGGGGGGGGGGGGGG
AAAAAAAAAAAAAAAAAAAAAAGGGGGGGGGGGGGGGGGGGGGGGGGGGG
AAAAAAAAAAAAAAAAAAAAADDGGGGGGGGGGGGGGGGGGGGGGGGGGG
AAAAAAAAAAAAAAAAAAAAADGGGGGGGGGGGGGGGGGGGGGGGGGGGG
AAAAAAAAAAAAAAAAAAAAADGGGGGGGGGGGGGGGGGGGGGGGGGGGG
AAAAAAAAAAAAAAAAAAAAAGGGGGGJJGGGGGGGGGGGGGGGGGGGGG
AAAAAAAAAAAAAAAAAAADDGGGGGJJJJJJJJGGGGGGGGGGGGGGGG
AAAAAAAAAAAAAAAAAAAGGGGGJJJJJJJJJGGJGGGGGGGGGGGGGG
AAAAAAAAAAAAAAAAAADGGGGJJJJJJJJJJJJJJJGGGGGGGGGGGG
AAAAAAAAAAAAAAAAAAGGGGGJJJJJJJJJJJJJJJGGGGGGGGGGGG
AAAAAAAAAAAAAAAAADGGGGGJJJJJJJJJJJJJJJGGGGGGGGGGGG
AAAAAAAAAAAAAAAADGGGGGJJJJJJJJMJJJJJJJJGGGGGGGGGGG
AAAAAAAAAAAAAAAADGGGGJJJJJJJJJMMJJJJJJJGGGGGGGGGGG
AAAAAAAAAAAAAAAADGGGJJJJJJJJJJMMMMJJJJJJGGGGGGGGGG
AAAAAAAAAAAAAAAADGGGJJJJJJJJJJJJJJJJJJJJJJGGGGGGGG
AAAAAAAAAAAAAAADDGGGGJJJJJJJJJJJJJJJJJJJJGGGGGGGGG
AAAAAAAAAAAAAADGGGGGJJJJJJJJJJJJJJJJJJJJJJGGGGGGJJ
AAAAAAAAAAAAAADGGGGGGJJJJJJJJJJJJJJJJJJJJGGGGGGJJJ
AAAAAAAAAAAAAADGGGGGGJJJJJJJJJJJJJJJJJJJJGGGGGGJJJ
AAAAAAAAAAAAAAGGGGGGGJJJJJJJJJJJJJJJJJJJJGGGGGGGJJ
AAAAAAAAAAAAAADGGGGGJJJJJJJJJJJJJJJJJJJGGGGGGGGJJJ
