PPPMMPPPPPPPJMJJPMPPPPPPPPMMMMMMJMMJJJJJJJJJJJJJJJ
MPMPPPPPPMPMMMMPPPPPPPPPPPPMMMMMJJMJJJJJJJJJJJJJJJ
MPPMPPPPPPPPMMMMPPPPPPPPPPPPMMJJJJMJJJJJJJJJJJJJJJ
PPPPPPPPPPPMMPMMPMMPPPPPPPPPMMJMMMJJJJJJJJJJJJJJJJ
PPPPPPPPPPPPPPMMPMMMMPPMMMPPPMMJJJJJJJJJJJJJJJJJJJ
MMPPPPPPPPPPMPMMPMMMMMMMMMJJMPMMJJJJJJJJJJJJJJJJJJ
PPPPPPPPMPMMMPMMPPPMMPMMMMPMMMMJJJJJJJJJJJJJJJJJJJ
PPPPPPPPPMMPMMPMPMPPMMMMMPMMMMMJJJJJJJJJJJJJGGGGJJ
MMPPPPPPMMPPPPPMPMPMPPMPPMPMMMJJJJJJJJJJJJGGGGGGJJ
PMPPPPMPPMPMMMPPPPMMPPPMMMMMJJJJJJJJJJJJJJGGGGGGGJ
MPPPPPMMMMMMMMMMPPMMPMMMMMMJJJJJJJJJJJJJJJGGGGGGGJ
MMPPPMPPMMMMMJMMMMMMMMPMMJJJJJJJJJJGJGGGGGGGGGGGGG
MMPPMMMMMMJJJJMMMMMMMMMMJJJJJJJJJGGJGGGGGGGGDDDDGG
MJMPPMMJMJJMJJMMMMMJMMJJMJJJJJJJGGGGGJGGDDADAAAADG
PJPPPMMMJJJJMJJMMMJJJMJJJJJJJJJJGJGGGGGGAAAAAAAADG
MJMMMMJMMMMMJJJJJJJJMMMMJJJJJJJJJGGGGGGDAAAAAAAAAD
MJMJMJJJMMMMJJJMMJJJJJMJJJJJJJJJGGGGGGGAAAAAAAAAAA
JMJJJJJJJMMJJJJJMJJJJJJJJJJJJJJJJGGGGDDAAAAAAAAAAA
MMMMMMJJJMMJJJMJMMMJJJJJJJJJJJJJGGGGADAAAAAAAAAAAA
JMPPMJJJJJMMMJMJMMJJJJJJJJJJJJJJGGGDDDAAAAAAAAAAAA
JMPPMMJJMMMJJJJJMJJJJJJJJJJJJJGGGGGDDAAAAAAAAAAAAA
MMMPJMJMMMJJJJJJJJJJJGGGJJJJGGGGGDDDDDAAAAAAAAAAAA
MMMMMJJJMMJJJJJJJJJJJGGGGGGGGGGGGDDDDAAAAAAAAAAAAD
PMPMPMJJJJJJJJJJJJJGGGGGGGGGGGGGGDDAAAAAAAAAAAAAAD
PMMPMMMJJJJJJJJJJJGGGGGGGGGGGGGGDDDAAAAAAAAAAAAAAA
PPMMMMMJJJJJMJJJJJGGGGGGGGGGGGDAAADAAAAAAAAAAAAAAA
PPMMMMMMJJJJJJJJJJJGGGGGGGGGGGDAAAAAAAAAAAAAAAAAAA
PMMJMMJMJJJJJJJJJJGGGGGGGGGGGGDAAAAAAAAAAAAAAAAAAA
PMMMMJJJJJJJJJJJJJGGGGGGGGGGGDDAAAAAAAAAAAAAAAAAAA
MPMMMJJJJJJJJJJJJJGGGGDDGDGGGAAAAAAAAAAAAAAAAAAAAA
MPMMJJJJJJJJJJGGGGGGGGDDGGDDAAAAAAAAAAAAAAAAAAAAAA
MMMJMJJJJJJJJJGGGGGGGGDDGDAAAAAAAAAAAAAAAAAAAAAAAA
MMMMMJJJJJJJJJGGGGGGGADDDAAAAAAAAAAAAAAAAAAAAAAAAA
MMMMJJJJJJJJJJJGGGGGDAAAAAAAAAAAAAAAAAAAAAAAAAAAAA
MMMJJMJJJMJJJJGGGGGGDAAAAAAAAAAAAAAAAAAAAAAAAAAAAA
MMMMMMMJJJJJJJJJGGGGAAAAAAAAAAAAAAAAAAAAAAAAAAAAAA
MMJJJMMMMMMJJJJJGGGDAAAAAAAAAAAAAAAAAAAAAAAAAAAAAA
JJJJJMMMMMMJJJJJJGGDAAAAAAAAAAAAAAAAAAAAAAAAAAAAAA
MJJJJJMMMMMMMJJJJGGDAAAAAAAAAAAAAAAAAAAAAAAAAAAAAA
JJJJJMMMMMMMMMJJJGGDAAAAAAAAAAAAAAAAAAAAAAAAAAAAAA
MMJJJJJMMMMMMMJJJGGDAAAAAAAAAAAAAAAAAAAAAAAAAAAAAA
MMJJJJMMMMMMMMJJJGGGDDDDAAAAAAAAAAAAAAAAAAAAAAAAAA
MMJJJMMMMMMMMMJJJJGGGGGGDDAAAAAAAAAAAAAAAAAAAAAAAA
MMJJJMMMMMMMJJJJJJJGGGGGGGDDAAAAAAAAAAAAAAAAAAAAAA
MJMJJMJMMMMMJJJJJJJGGGGGGGGDDDDAAAAAAAAAAAAAAAAAAA
JJJJJMMMMMMJJJJJJJJGGGGGGGGGGDAAAAAAAAAAAAAAAAAAAA
JJJJJJMMMMMMMJJJJJJGGGGGGGGGGDAAAAAAAAAAAAAAAAAAAA
JJJMMMMMMMMMMMJJJJJJJGGGGGGGGGDAAAAAAAAAAAAAAAAAAA
JMMMMMMMMMMMJJJJJJJJJGGGGGGGGGDAAAAAAAAAAAAAAAAAAA
MMMMMMMMJMJJJJJJJJJJJJJJJJJGGGGAAAAAAAAAAAAAAAAAAA
