GGGJJJJJGGJJGGGGGGJJJJJJJJJJJJJJMMJMMJMMMMMJMJJMMM
GGGGGGGGGGGGGGGGGGGJJJJJJJJJJJJJJMMMMMMJJMMMMMMMMM
GGGGGGGGGGGGGGGGGGGGJJJJJJJJJJJJMMJJMMPMMMMMPMMMMM
GGGGGGGGDDDGDDDDDGGGGJJJJJJJJJJJJJJJJMMPPPMPPPPMPM
GGGGGGGDDDDDDDDDDDGGGGJJJJJJJJJJJJJJJMPPPPPPPPPPPP
GGGGGGGDDDDDDDDGDDGGGGJJJJJJJJJJJJJJMPMMPPPPPPPPPP
GGGGGGGGDDDDDDDDDDDGGGGJJJJJJJJJJJMMMMMPPPPPPPPPPP
GGGGGGGGGGDDDDDDDDDGGGGJJJJJJJJJJJMMMMMMPMPPPPPPPP
GGGGGGGGGGGDDDDDDDDDGGGJJJJJJJJJJJJJJJJMPPPPPPPPPP
GGGGGGGGGGGGDDDDDDDDDGGGJJJJJJJJJJJJJJMMPPPMPPMPPP
GGGGGGGGGGGDDDDDDDDDDGGGJJJJJJJJJJMJJMJMJPJMMMMPPP
GGGGGGGGGGDDDDDDDDDDGGGGJJJJJJJJJMMMMJMMPMMPPPPPPP
GGGGGGGGDDDDDDDDDDDDGGGGJJJJJJJJJJJMMMMPPPPPPPPPPP
GGGGGGGGDDDDDDDDDDDDGGGGGGJJJJJJJMJJMMPPPPPPPPPPPP
GGGGGGDDDDDDDDDDDDDDGGGGGJJJJJJJJMJMMMMPPPPPPPPPPP
GGGGGDDDDDDDDDDDDDDDDGGGJJJJJJJJJJJMMMMPPPPPPPPPPP
GGGGDDDDDDDDDDDDDDDDDGGGJJJJJJJJJJJJMMJMMPPPPPPPPP
GGGDDDDDDDDDDDDDDDDDDDGGGGGGJJJJJJJJJMMMMPPPPPPPPP
DDDDDDDDDDDDDDDDDDDDDDGGGGGGJJJJJJJJMJMMPPPPPPPPPP
DDDDDDDDDDDDDDDDDDDDDDDGGGGGJJJJJJJJMJMPPPPPPPPPMP
DDDDDDDDDDDDDDDDDDDDDDGGGGGJJJJJJJJMMMMPPPPPPPPPPP
DDDDDDDDDDDDDDDDDDDDDGGGGGJJJJJJJJJMMMMPPPPPPPMMMM
DDDDDDDDDDDDDDDDDDDDDGGGGGGJJJJJJJJMMMPMMMPPPPMMJM
DDDDDDDDDDDDDDDDDDDDDGGGGGJJJJJJJJMMMMPPMPPPPMJJJM
GDDDDDDDDDDDDDDDDDDDDGGGGJJJJJJJJJJMMMMPPPPMMJMMPM
GGDDDDDDDDDDDDDDDDDDDDGGGGJJJJJJJJJMMMMPPPMMJJJMJM
GGDDDDDDDDDDDDDDDDDDDDGGGGJJJJJJJJJJMMMMMMMMJJJJMM
DDDDDDDDDDDDDDDDDDDDDDDGGGJJJJJJJJJJJMMMMJJJJJJJMP
GGGDDDDDDDDDDDDDDDDDDDDGGGGJJJJJJJJJJMMMJJJJJJJMMM
GGGDDDDDDDDDDDDDDDDDDDDDGGGGJJJJJJJJJJMMJJJJJJJJJJ
GDDDDDDDDDDDDDDDDDDDDDDDGGGGJJJJJJJJJJJJJJJJJJJJJJ
DDDDDDDDDDDDDDDDDDDDDDDDGGGGGJJJJJJJJJJJJJJJGGJJJJ
GGDDDDDDDDDDDDDDDDDDDDDDDGGGGJJJJJJJJJJJJJJJJJJJJM
DGGDDDDDDDDDDDDDDDDDDDDDDDGGGGGJJJJJJJJJJJJJJJJJJJ
DGGGDDDDDDDDDDDDDDDDDDDDDDDDGGGJJJJJJJJJJJJJJJJJJJ
GGGGDDDDGGGGDDDDDDDDDDDDDDDDDGGGJJJJJJJJJJJJJJJJJJ
GGGGGGGGGGGGGGDDDDDDDDDDDDDDDGGGJJJJJJJJJJJJJJJJJJ
GGGGGGGGGGGGGGGGDDDDDDDDDDDDDGGGGJJJJJJJJJJJJJJJJJ
GGGGGGGGGGGGGGGGGGDDDDDDDDDGGGGGGGJJJJJJJJJJJJJJGG
GGGGGGGGGGGGGGGGGDDDDDDDDDDDGGGGGGJJJJJJJJJJJJJGGG
JJJGJJJJGGGGGGGGGGGDDDDDDDGGGGGGGGJJJJJJJJJJJGGGGG
JJJJJJJJJJGGJJGGGGGGGDDDDDDGGGGGGGJJJJJJJJJJJGGGGG
JJJJJJJJJJJJJJGGGGGGGGGGGGGGGGGGGGGJJJJJJJJJGGGGGG
JJJJJJJJJJJJJJGGGGGGGGGGGGGGGGGGJJJJGJGGGGGJJGGGGG
JJJJJJJJJJJJJJJGGGGGGGGGGGGGGGGGJJJJJJGGGGGGJJJJGG
JJJJJJJJJJJJJGGGGGGGGGGGGGGGGGGGJJJJJGJJJJGGGJJGGG
GJJJJJJJJJJGGGGGGGGGGGGGGGGGGGGGJJJGGJJJJJGGGGJGGG
JJJJJJJJJJGGGGGGGGGGGGGGGGGGGGGJJJGGGJJJJJJGGGGGGG
JJJJJJJJJGGGGGGGGGGGGGGGGGGGGGGJGGJGGJJJJJJJJGGGGG
JJJJJJJJJJGGGGGGGGGGGGGGGGGGGGGGGGGGGJJJJJJJJJGJJJ
