MMMMMMJMJJJJJJJJJJJJJGGDDDDDDDDGDDDDDDGGGAADGGDDDD
MMMJJJJJJJJJJJJJJJJJGGGADAAAADADGDDDAADDDAAADGGDDD
JMJJJJJJJJJGGJJJJJJJGGGAAAAAAAADDADAAAAAAAADDGGGGD
JJJJJJJJJGGGGJJJJJJGGGAAAAAAAAADDAAAAAAAAAADDGGGGD
JJJJJJJGGGGGGJJJJJGGGDAAAAAAAAAAAAAAAAAAAAADDGGGGD
JMJJJJJGGGGGGGJGGJJGGDAAAAAAAAAAAAAAAAAAAAAAADDDGD
JJJJJJJGGGGGGGJGGGGGGDAAAAAAAAAAAAAAAAAAAAAAAAADDD
JJJJJJJJGGGGGGGGGGGGGGAAAAAAAAAAAAAAAAAAAAAAAAAAAA
JJJJJJJGJGGGGGGGGGGGGGAAAAAAAAAAAAAAAAAAAAAAAAAAAA
JJJJJGGJJGGGGGGGGGGGDDAAAAAAAAAAAAAAAAAAAAAAAAAAAA
JJJJJJJJJJGGGGGGGGGGDDAAAAAAAAAAAAAAAAAAAAAAAAAAAA
JJJJJJJJJJJJGGGGGGGDDDDAAAAAAAAAAAAAAAAAAAAAAAAAAA
JJJJJJJJJJJJGGGGGGGDDDDDDDAAAAAAAAAAAAAAAAAAAAAAAA
JJJJJJGGGJGGGGGGGGGDDDDGGDDAAAAAAAAAAAAAAAAAAAAAAA
JJJJJJGGGGGGGGGGGGGGGGDGDDDAAAAAAAAAAAAAAAAAAAAAAA
JJJJJGGGGGGGGGGGGGGGGGGGGDDAAAAAAAAAAAAAAAAAAAAAAA
JJJJJGGGGGGGGGGGGGGGGGGGGGDAAAAAAAAAAAAAAAAAAAAAAA
JJJJJGGJGGGGJJGGGGGGGGGGGGAAAAAAAAAAAAAAAAAAAAAAAA
JJJJJJJJGJJJJJJJGGGGGGGGGDDAAAAAAAAAAAAAAAAAAAAAAA
JJJJJJJJJJJJJJJJGGGGGGGGGGDAAAAAAAAAAAAAAAAAAAAAAA
JJJJJJJJJJJJJJJJJGGGGGGGGGDAAAAAAAAAAAAAAAAAAAAAAA
JJJJJJJJJJJJJJJJJJGGGGGGGGGDDAAAAAAAAAAAAAAAAAAAAA
JJJMMMJJJJJJJJJJJJGGGGGGGGGGDDAAAAAAAAAAAAAAAAAAAA
MMMMMMJJJJJJJJJJJJJGGGGGGGGGGDAAAAAAAAAAAAAAAAAAAA
MMMMMJJJMMJMMJJJJJJGGGGGGGGGDDAAAAAAAAAAAAAAAAAAAA
MMPMMMMMMMMMMMJJJJJGGGGGGGGGDDAAAAAAAAAAAAAAAAAAAA
MMMMMMJMMMMMMMJJJJJGGGGGGGGGGDAAAAAAAAAAAAAAAAAAAA
PPMMMMMMPPMMMMJJJJGGGGGGGGGGGGDDDAAAAAAAAAAAAAAAAA
MMMMMMMPPPPMMJJJJJJGGGGGGGGGGGGDDAAAAAAAAAAAAAAAAA
MMMMPMPMPPMMMMJJJJGGGGGGGGGGGGGGGGDAAAAAAAAAAAAAAA
MMMMPPPPPMMMMJJJJGGGGGGGGGGGGGGGGGGDAAAAAAAAAAAAAA
MMPPPPPPPMMMMMJJJJGGGGGGGGGGGGGGGGGDDAAAAAAAAAAAAA
MPPPPPPPMMMMMMMJJJJGGGGGGGGGGGGGGGGGDAAAAAAAAAAAAA
PPMMPPPMMMMMMMJJJJJGGGGGGGGGGGGGGGGGDDAAAAAAAAAAAA
MMPPPPMMMMMMJMMMJJJJGGGGGGGGGGGGGGGGGDDAAAAAAAAAAA
MMMMPPMMMMMMMMMMJJJJGGGGGGGGGGGGGGGGGGGDAAAAAAAAAA
MMMMMPPMMMMMMMMJJJJJJJJJGGGGGGGGGGGGGGGGDAAAAAAAAA
MMMJMMPMPMMMMMMJJJJJJJJJJJGGGGGGGGGGGGGGGGDAAAAAAA
MMJJMMPMMMMMMMMMMJJJJJJJJGGGGGGGGGGGGGGGGGGDDAAAAA
MMMMMMMMPPMMMPMMJJJJJJJJJJGGGGGGGGGGGGGGGGGGGDDAAA
MMMMMPPPPPPMMPMMMMJJJJJJJJJGGGGGGGGGGGGGGGGGGDAAAA
JJMPMPPPPPPPPPMMMMMJJJJJJJJJGGGGGGGGGGGGGGGGGGDAAA
MMJMMMPPPPPMMMMMMMJJJJJJJJJJJGGGGGGGGGGGGGGGGGDAAA
MMMMMPMPPPMMMMJJJMJJJJJJJJJJJGGGGGGGGGGGGGGDDDDAAA
JMPMMPPMMMPMMMMMMJMJJJJJJJJJJGGGGGGGGGGGGGDDDDAAAA
MMJJMMPPPPMJMJJJMJJJJJJJJJJJJJGGGGGGGGGGGGGGGGDAAA
MMJJJMJMMMMMMJJJJJJJJJJJJJJJJJGGGGGGGGGGGGGGGDDAAA
MMMJMMJJJJMMJJJJJJJJJJJJJJJJJJJGJJGGGGGGGGGGGDDAAA
MMMMMMMMJMJMJJJJJJJJMJJJJJJJJJJJJJJJGGGGGGGGGGDAAA
MMJMMPPMJJMJJJJMMMMMMMMMJJJJJJJJJJJJGGGGGGGGGGDDAA
