DDDDGGGGGGGDDDGGGGJJJJJJJGGGGGGGGGGGGGGDDAAAAAADDD
DDDDGGGGGDDDDDDGGGGJJJGGGGGGGGGGGGGGGDDAAADAAAADDD
DDDDGGGDDDDDDDDGGGGGGGGGGGGGGGGGGGDGGDDAADDDDDDDDD
DDDDGGDDDDDDDDDDGGGGGGGGGGGGGDDDDDDDDAAAADDGGGDDDD
DDDDDGGDDDDDDDDDGGGGGGGDGGDDAAAAAAADAAAAADGGGGGDDD
DDDDDGGGDDDDDDDDGGGGGGDDDDDAAAAAAAAAAAAAADGGGGGDDD
DDDDDGGGGDDDDDDDGGDDDDDDDAAAAAAAAAAAAAAADGGGGGGDDD
DDDDDGGGGGDDDDDDDGDDDAAAAAAAAAAAAAAAAAAADGGGGGDDDD
DDDDDGGDDDDDAAAADDAAAAAAAAAAAAAAAAAAAAAAADGGGGGDDD
DDDDGGGDDADAAAAAAAAAAAAAAAAAAAAAAAAAAAAAADGGGGGDDD
DDDDGGDDAADAAAAAAAAAAAAAAAAAAAAAAAAAAAAADDGGGGGGGD
DDDDDDDAAAAAAAAAAAAAAAAAAAAAAAAAAAAAAAADGGGGGGGGGD
DDDDDDAAAAAAAAAAAAAAAAAAAAAAAAAAAAAAAADGGGGGGGGGGG
GGGGGDAAAAAAAAAAAAAAAAAAAAAAAAAAAAAAADDGGGGGGGGGGG
GGGGGDDAAAAAAAAAAAAAAAAAAAAAAAAAAAAAAADGGGGGGGGGGG
GGGGGGDDAAAAAAAAAAAAAAAAAAAAAAAAAAAAAADGGGGGGGGGGG
GGGGGGDDAAAAAAAAAAAAAAAAAAAAAAAAAAAAAADGGGGJGGGGGG
GGGGGGDAAAAAAAAAAAAAAAAAAAAAAAAAAAAAAADGGGGGGGGGGG
GGGGGGGDAAAAAAAAAAAAAAAAAAAAAAAAAAAAAAAGGGGGGGGGGG
GGGGGGGDDAAAAAAAAAAAAAAAAAAAAAAAAAAAAADDGGGGGGGGGG
GGGGGGGDDAAAAAAAAAAAAAAAAAAAAAAAAAAAAADGGGGGJJJJJJ
JGGGGGGDDDDDAAAAAAAAAAAAAAAAAAAAAAAAADGGGGJJJJJJJJ
JJJJGGGGDDDDDAAAAAAAAAAAAAAAAAAAAAAADDGGGJJJJJJJJJ
JJJJJGGGGGDDDDAAAAAAAAAAAAAAAAAAAADDGGGGGJJJJJJJJJ
JJJJJGGGGGGGDDAAAAAAAAAAAAAAAAADDDGGGGGGJJJJJJJJJJ
JJJJJJGGGGGDDDDDAAAAAAAAAAAAAAAADDGGGGGGJJJJJJJJJJ
JJJJJJGGGGGDDDGDAAAAAAAAAAAAAAAAGGGGGGGGJJJJJJJJJJ
JJJJJJGGGGDDDDDDAAAAAAAAAAAAAAAADGGGGGGGGJJJJJJJJJ
JJJJJJJGGGDDDDDAAAAAAAAAAAAAAAAAGGGGGGGGJJJJJJJJJJ
JJJJJJGGGGGDDAAAAAAAAAAAAAAAAAAADGGGGGGGGJJJJJJJJJ
JJJJJJJJGGGDDAAAAAAAAAAAAAAAAAAAGGGGGGGGJJJJJJJJJJ
JJJJJJJJJGGGDDAAAAAAAAAAAAAAAAADGGGGGGGJJJJJJJJJJJ
JJJJJJJJJGGGGDAAAAAAAAAAAAAAAAADGGGGGGGGGJJJJJJJJJ
JJJJJJJJJGGGGDAAAAAAAAAAAAAAAAAADGGGGGJGJJJJJJJJJJ
JJJJJJJJJGGGGGAAAAAAAAAAAAAAAAADGGGGGGJJJJJJJJJJJJ
JJJJJJJJGGGGGGDDAAAAAAAAAAAAAADDGGGGGJJJJJJJJJMJJJ
JJJJJJJJGGGGGGGDAAAAAAAAAAAAAADGGGGGJJJJJJJJJMMJJJ
JJJJJJJGGGGGGGDDAAAAAAAAAAAAAAGGGGJJJJJJJJJJMMMMJM
JJJJJJJGGGGGGGGGDAAAAAAAAAAAADGGGGJJJJJJJJJMMMMMMM
MMJJJJJGGGGGGGGGGDDDDDAAAAAADDGGGGJJJJJJJJJJMMMMMM
MMJJJJJGGGGGGGGGGGGGGGAAAAAADGGGGGGJJJJJJJJJMMMMMM
MMMJJJJGJJJGGJJGGGGGGGDAAAADDGGGGGJJJJJJJJJJMMMMMM
MMMJJJJJJJJJJJJJGGGGGGDAAADGGGGGGGJJJJJJJJJJMMMMMM
MMMJJJJJJJJJJJJJJGGGGGGDDDGGGGGGGGJJJJJJJJJJMJMMMM
MMJJJJJJJJJJJJJJJJGGGGGGDDGGGGGGGJJJJJJJJJJJJJMJMJ
MMMJJJJJJJJJJJJJJJJJGGGGGDGGGGGGGGGJGJJJJJJJMJMJMJ
MMJJJJJJJJJJJJJJJJJJJGGGGGGGGGGGGGGJJJJJJJJJJJMJMM
MMJJJMMMJJJJJJJJJJJJJGGGGGGGGGGGGGJJJJJJJJMJMMMMMM
MMMMMMMMMJJJJJJJJJJJJJGGGGGGGGGGGGJJJJJJJMMMMMMMMP
PMMMMMMMMJMJJJJJJJJJJJGGGGGGGGGGGGJJJJJJMMMMMMMMMP
