AAAAAAAAAAAAAAADDGGGGGGJJGGGGGGGGGGGGGGGGGGGJJJJJJ
AAAAAAAAAAAAAAADDGGGGGGJJGGGGGGGGGGGGGGGGGGJJJJJJJ
AAAAAAAAAAAAAAADDGGGGGGGGGGGGGGGGGGGGGGGGGGJJJJJJM
AAAAAAAAAAAAAAAADDGGGGGGGGGGGGGGGGGGGGGGJGJJJJJJJJ
AAAAAAAAAAAAAAAADDGGGGGGGGGGGGGGGGGGGGGJJJJJJJJJJJ
AAAAAAAAAAAAAAAAADGGGGGGGGJJJGGGGGGGGGGJJJJJJJJJJM
AAAAAAAAAAAAAAAAAADGGGGGGJJJGGGGGGGGGGJJJJJJJJJJJM
AAAAAAAAAAAAAAAAAADDGGGGGGJJJGGGGGGGGGJJJJJJJJJJJJ
AAAAAAAAAAAAAAAAAADGGGGGGGJJJJJJGGGJGJJJJJJJJJJJJJ
AAAAAAAAAAAAAAAAAADGGGGGJJJJJJJJGGGGJJJJJJJJJJJJJJ
AAAAAAAAAAAAAAAAAAAGGGGJJJJJJJGGGGGGJJJJJJJJJJJJJJ
AAAAAAAAAAAAAAAAAAAGGGGJJJJJJJGGGGGJJJJJJJJJJJJJJJ
AAAAAAAAAAAAAAAAAADGGGJJJJJJJGGGGGJJJJJJJJJJJJJJJJ
AAAAAAAAAAAAAAAAAADGGGJJJJJGGGGGGGJJJJJJJJJJGJJJJJ
AAAAAAAAAAAAAAAAAADGGGJJJJJGGGGGGGJJJJJJJJGGGJJJJJ
AAAAAAAAAAAAAAAAADGGGJJJJJJGGGGGGJJJJJJJJJJGJGJJJJ
AAAAAAAAAAAAAAADDGGGGJJJJJJJGGJJGGGGJJJJJJJJJJJJJJ
AAAAAAAAAAAAAADDGGGGJJJJJJJJJJJJGGGJJJJJJJJJJJJJJJ
AAAAAAAAAAAAAADGGGGGJJJJJJJJJJJJGGGGJJJJJJJJJJJJJJ
AAAAAAAAAAAAAADGGGGJJJJJJJJJJJJJGGGJJJJJJJJJJJJJJJ
AAAAAAAAAAAAADGGGGGJJJJJJJJJJJJJJGGJJJJJJJMMJJJJJJ
AAAAAAAAAAAAADGGGGGJJJJJJJJJJJJJGGJJJJJJJMMMMJJJMM
AAAAAAAAAAAADGGGGGGJJJJJJJJJJJGGGGJJJJJJJMMJMJJMMM
AAAAAADDDDDDDGGGGGGGJJJJJJJJJJGGGGGJJJJJJJMMMMJJJJ
AAAAAADDGGGGGGGGGGGGJJJJJJJJJJGJGGJJJJJJJJMMMMJJJJ
AAAAAADDGGGGGGGGGJGJJJJJJJJJJJGGJGGGJJJJJJMJJJMJJJ
AAAAAADGGGGGGGGGGJJJJJJJJJJJJJJJGGGGGJJJJJJJJMMMJJ
AAAAADGGGGGGGGGJJJJJJJJJJJJJJJJJGGGGGGJJJJJMJMMMMJ
AAAAADGGGGGGGGGJJJJJJJJJJJJJJJJJGGGGJJJJJJJMJJJMMM
AAAAADDGGGGGGGGJJJJJJJJJJJJJJJJJJJJJJJJJJJMMMMMJMM
AAAAAADDGGGGGGGJJJJJJJJJJJJJJJJJJJJJJJJJJJJMMMMMMM
AAAAAAAADDGGGGJJJJJJJJJJJJJJJJJJJJJJJJJJJMMMMMPMPM
AAAAAAADDDGGGGJJJJJJJJJJJJJJJJJJJJJJJJJJJMMMMPPPPM
AAAAAADGGGGGGGJJJJJJJJJJMMMJJJJJJJJJJJJJJMMJMMPPPP
AAAAADGGGGGGGGJJJJJJJJMMMMMMJJJJJJJJJJJJJJJJJMPMPP
AAAAADGGGGGGGJJJJJJJJJJMMMMMMJJJJJJJJJJJJJJJJJMPMP
AAAAADGGGGGGGJJJJJJJJMJMMMMMMMMJJJJJJJJJJJMJJMMMPP
AAAAADGGGGGGJJJJJJJJJJJMMMMMMMJJJJMJJJJJJMJMMJJMMM
AAAAADGGGGGGJJJJJJJJJJJMMMMMMJJJJJMMJJJMJMMPMMJMMM
AAAAAADDGGGGGJJJJJJJJJJMMMMJMMMMMMMMMJJMMMMPPMMMMP
AAAAAAADDGGGGGJJJJJJJJMMMMMMMMMMMMMMMMJMMPPPPPMPMP
AAADAAAADGGGGJJJJJJJMMMMMMMMJMMMMMMMPPPPMPPPPMPPPP
AAADDAAAGGGGGJJJJJJJJJJMMMMMMMMMMMMMPPPPMPPPPPPPPP
AAAADAADDGGGGJJJJJJJJMMMMMMMJMMMMMMMPPPPPPPPPPPPPP
AAAAAAAADGGGGGJJJJJJJJMMMMMMMMJJMMMMMMMPPPPPPPPPPP
AAAAAAADGGGGGGJJJJJJJMJJJJJJJJJJMJMMMMMPPPPPPPPPPP
AAAAAAADGGGGGJJJJJJJJJJJJJJJJJJJJJMMJJMMPPMMPPPPPP
AAAAAADGGGGGJJJJJJJJJJJJJJJJJJJJJJMJJJMPPMMPPPPPPP
AAADDDDGGGJJJJJJJJJJJJJJJJJJJJJMMJMMMMJPMMPPPPPPPP
ADGGGGGGGJJJJJJJJJJMJJJJJJJJJJJMMJMMMMJMPMMPPPMMPP
