AAAAAAAAAAAAAAAAAAAAAAAAAAAAAAAAAAAAAAAAAAAAAAAAAA
DDDAAAAAAAAAAAAAAAAAAAAAAAAAAAAAAAAAAAAAAAAAAAAAAA
GGDDADAAAAAAADDDDAAAAAAAAAAAAAAAAAAAAAAAAAAAAAAAAA
GGGDDDDDDDDADDDDDDAAAAAAAAAAAAAAAAAAAAAAAAAAAAAAAA
GGGGGGGDDDDDDDGDDDAAAAAAAAAAAAAAAAAAAAAAAAAAAAAAAA
GGGGGGGGGGGDGGGGDDAAAAAAAAAAAAAAAAAAAAAAAAAAAAAAAA
GGGGGGGGGGGGGGGGDDAAAAAAAAAAAAAAAAAAAAAAAAAAAAAAAA
GGGGGGGGGGGGGGGGDAAAAAAAAAAAAAAAAAAAAAAAAAAAAAAAAA
GGGGGGGGGGGGGGGDAAAAAAAAAAAAAAAAAAAAAAAAAAAAAAAAAD
GGGGGGGGGGGGGGGDAAAAAAAAAAAAAAAAAAAAAAAAAAAAAAADDG
GGGGGGGGGGGGGGGDAAAAAAAAAAAAAAAAAAAAAAAAAAAAAAGGGG
GGGGGGGGGGGGGGGGAAAAAAAAAAAAAAAAAAAAAAAAAAAADGGGGG
GGGGGGGGGGGGGGGGDAAAAAAAAAAAAAAAAAAAAAAAAAADGGGGGG
GGGGGGGGGGGGGGGDDAAAAAAAAAAAAAAAAAAAAAAAAADGGGGGGJ
GGGGGGGGGGGGGGGGDAAAAAAAAAAAAAAAAAAAAAAAADGGGGGGGG
GGGGGGGGGGGGGGGDDAAAAAAAAAAAAAAAAAAAAAAAGGGGGGGGJJ
GGGGGGGGGGGGGGGGDAAAAAAAAAAAAAAAAAAAAAADGGGGGJJJJJ
GGGGGGGGGGGGGGGGDDAAAAAAAAAAAAAAAAAAAAADGGGGGJJJJJ
GGGGGGGGGGGGGGGGDDAAAAAAAAAAAAAAAADADADGGGGGGJJJJJ
GGGGGGGGGGGGGGGGGGDAAAAAAAAAAAAAAADDDDGGGGGGJJJJJJ
GGGGGGGGGGGGGGGGGGGDAAAAAAAAAAAAADDDGGGGGGGGJJJJJG
GGGGGGGGJJJJGGGGGGDAAAAAAAAAAAAADDGGGGGGGGGGJJJJGG
GGGGGGGJJJJJGGGGGGDAAAAAAAAAAAADDDGGGGGGGGGGGJGJGG
GGGJGGGGJJJJJGGGGGDAAAAAAAAAAAADDDGGGGGGGGGGGGGGGG
GGGJJJJJJJJJJGGGGGGDAAAAAAAAAAADDDGGGGGGGGGGGGGGJG
JGJJJJJJJJJJJJGGGGGDAAAAAAAAAADDDGGGGGGGGGGGGGGGJJ
JJGJJJJJJJJJJJGGGGGGDAAAAAAAAADGDDGGGGGGGGJJGGGGJJ
GGJJJJJJJJJJJJGGGGGGDAAAAAAAAADDDDGGGGGGGGGGGGGGJJ
GJJJJJJJJJJJJJJGGGGGDAAAAAAAAADDDDDGGGGGGGGGJJJJJJ
GGJJJJJJJJJJJJJJJGGGGDDAAAAAAADGDDGGGGGGGGGGGJJJJJ
JJJJJJJJJJJJJJJJJJGGGGDDAAAAADDGGGGGGGGGGGGGJJJJJJ
JJJJJJJJJJJJJJJJJJGGGGDDDDAAADDGGGGGGGGGGGGGJJJJGJ
JJJJJJJJJMJJJJJJJGGGGGDDDDDDDGGGGGGGGGGGGGGGJJJGGG
JJJMJMJMMMMMMJJJJGGGGGDDDDDGGGGGGGGGGGGGGGJGGGGGGG
JJJJMMMMMMMMMMJJJJGGGGGGDDDGGGGGGGGGJJJGGGGJGGGGGG
JJMMJMMMMMMMMMJJJJGGGGGGDDDDGGGGGGGGJJJJGGGGJJGGGG
JJJMMMMMMMMMMMJJJJJJGGGGDDDDGGGGGGGGJJJJGGGGJJJGGG
JMMMMMMMMMMMMMJJJJJJJGGGDDDDGDGGGGGJJJJJJJJJJJGGGJ
MMMMPPPMMMMMMMJJJJJJJGGGGGDDDGGGGGGJJJJJJJJJJJGGGG
PPPPPPPMMMMMJMJJJJJJJJGGGGGDGGGGGGJJJJJJJJJJJJJGGG
MPPPPPPPMMMMMMJJJJJJJJGGGGGGGGGGGGJJJJJJJJJJJJJJGG
MPPPPPPPPMMMMJJJJJJJJGGGGGGGGGGGGGGJJJJJJJJJJJJJGG
PPPPPPPPPPMMMJJJJJJJGGGGGGGGGGGGGGGGJJJJJJJJJJJJGG
PPPPPPPPPPMMJJJJJJJJGGGGGGGGGGGGGJJJJJJJJJJJJJJJJG
MPPPPPPPMMJMMJJJJJJJJGGGJJGGGGGGJGJJJJJJJJJJJJJJJG
PPPPPPPMMMJMJJJJJJJJJJJJJJJGGGGGGGJJJJJJJJJJJJJJJJ
MPPPPMMMJMMJJJJJJJJJJJJJJJJJJGGGGGJJJJJJJJJJJJJJJJ
MPPPPMMMMJJJJJJJJJJJJJJJJJJJJJJGJJJJJJJJJJJJJJJJJJ
PPPPMMMMJMJJJJJJJJJJJJJJJJJJJJJJJJJJJJJJJJJJJJJJJJ
PPPPMMMMJJMJMMJJJMMJJJJJJJJJJJJJJJJJJJJJJJJJJJJJJJ
