GGJJJJJJJJJJJJJJJJJJJGGGGGGGJGGJJJJJMMMPMMMJMMMMJJ
GJJJJJJJJJJJJJJJJJJJJGGGGGGGGGGJJJJMMMMMMPPMMMMMMM
GJJJJJJJJJJJJJJJJJJJJGGGGGGGGGGGJJJMMMMMPPPPMMMJJJ
GGJJJJJJJJJJJJJJJJJJJJGGGGGGGGGGJJJJMMMMMPMMMMMMJJ
GJJJJJJJJJGJGJJJJJJJJJGGGGGGGGGGGJJJMMMMMMMMMJMMJM
JJJJJJJJGGGGGGJJJJJJJJGGGGGGGGGGGGJJJMMMMMMMMMMMMM
JJJJJJJJJGGGGGGGGJJJJGGGGGGGGGGGGGJJJJMMMMMMMJMMJJ
JJJJJJJJGJGGGGGGJJGJJGGGGGGGGGGGGGJJJJMMMMJMMJMMMJ
JJJJJJJJJJGGGGGGGGGGGGGGGGGGGGGGGGJJJJMMMMMMMJMJJJ
JJJJJJJJGGGGGGGGGGGJGGGGGGGGGGGGGGJJJJJJMMMJMMMMMJ
JJJJJJGGGGGGGGGGGGGGGGGGGGGGGGGGGGJJJJJJMMMMMMMMJJ
JJJJJGGGGGGGGGGGGGGGGGGGGGGGGGGGGGGJJJJJMMMMMMMMJJ
JJJJJGGGGGGGGGGGGGGGGGGGGGGGGGGGGGJJJJJJMMMMMMMJJJ
JJJJGGGGGGGGGGGGGGGGGGGGGGGGGGGGGGGGJJJJJJJMMMJJJJ
JJJJJGGGGGGGGGGGGGGGGGGGGGGGGGGGGGGGJJJJJJJJMJMJJJ
JJGGJGGGGGGGGGGGGGGGGGGGGGGGGGGGGGGGGGJJJJJJJJJJJJ
GGGGGGGGGGGGGGGGGGGGGGGGGGGGGGGGGGGGGGGGGJJJJJJJJJ
GGGGGGGGGGGGGGGGGGGGGGGGGGGGGGGGGGGGGGGGGGJGGJGJJJ
GGGGGGGGGDDDDDGGGGGGGGGGGGGGGGGGGGGGGGGGGGGGGGGGGJ
GGDAAADDDAAAADGGGGGGGGGGGGGGGGGGGGGGGGGGGGGGGGGGGJ
DAAAAAAAAAAAADGGGGGGGGGGGGGGGGGGGGGGGGGGGGGGGGGGJJ
AAAAAAAAAAAAAADGGGGGGGGGGGGGGGGGGGGGGGGGGGGGGGGJJJ
AAAAAAAAAAAAAADDGGGGGGGGGGGGGGGGGGGGGGGGGGGGGGGGJJ
AAAAAAAAAAAAAAADDGGGDGGGGGGGGGGGGGGGGGGGGGGGGGGGGJ
AAAAAAAAAAAAAAAAADDDDGGGGGGGGGGGGGGGGGGGGGGGGGGJGJ
AAAAAAAAAAAAAAAAADDDGGGGGGGGGGGGGGGGGGGGGGGGGGGGJJ
AAAAAAAAAAAAAAAAADDGGGGGGGGGGGGGGGGGGGGGGGGGGGGJJJ
AAAAAAAAAAAAAAAAADDGGGGGGGGGGGGGGGGGGJJJJJGGGGGJJJ
AAAAAAAAAAAAAAAAADGGGGGGGGGGGGGGGGGJJJJJJJGGJJJJJJ
DAAAAAAAAAAAADAADGGGGGGGGGGGGGGGGGGGJJJJJJJJJJJJJJ
DAAAAAAAAAAAADDDDGGGGGGJJGGGJGGGJJGJJJJJJJJJJJJJJJ
DAAAAAAAAAAAGGGGGGGGGJJJJJJJJJJJJJJJJJJJJJJJJJJJJJ
AAAAAAAAAAAGGGGGGGGGJJJJJJJJJJJJJJJJJJJJMJMJJJJJMM
AAAAAAAAAGGGGGGGGGGJJJJJJJJJJJJJJJJJJJJMMMMJJJMMMM
AAAAAAAAAGGGGGGGGGGJJJJJJJJJJJJJJJJJJJJMMMMMMJMMMM
AAAAAADDGGGGGGGGGGGJJJJJJMMMMMJJJJJJJJMMMMMMJJMMJM
AAAAAADGGGGGGGGGGGJJJJJJMMMMMMMMJJJJJMMMMMMMJMMJJM
DAAAADGGGGGGGGGGJJJJJJJMMMMMMJMJJMMMMJJMMMMMMJMJMM
GDDGGGGGGGGGGGGGJJJJJJJMMMMMMJMMJJJMJMMMMMMMMMJMMM
GGGGGGGGGGGGGGGJJJJJJJJMMMJJJJJJJJMMMMMMMJMJJJMMMP
GGGGGGGGGGGGGGGJJJJJJJMMMMJJJJJJJMMMMMMMMMJJJJJMJM
GGGGGGGGGGGGGGGGJJJJJJJMMMMMJJJJMJMMMMMMJMMJMJMMMP
GGGGGGGGGGGGGGGGJJJJJJJJMMMMJJJJJJJMMMMMMMMMMJMMMM
GGGGGGGGGGGGGGGGJJJJJJJJJMMMMJJJMJMJMMMPPMMMJMMPPP
GGGGGGGGGGGGGGGGGJJJJJJJMMMMMJJMMMMMMMMMMMMMJMMPPP
GGGGGGGGGGGGGGGGGJJJJJJMMMMMMJJMMMMMMMMMMJMMMMMMPP
GGGGGGGGGGGGGGGGGJJJJJMMMMMMMMMMMMPMMMMMMMMJJMMPPP
GGGGGGGGJJGGGGGGGGJJJJJJJJMMJMMMMMPMMPMPMMMMMMMPPP
GGGGGGGJJJGGGGGGGJJJJJJJJJMJJMMMMMMMMMMPPMMMMMMMPP
GJJJGGJJJJJGGGGGGGJJJJJJJJJMMJMMMMMMMMMMMMMMPMJMMP
