GGGGGGGGGGGGGDAAAAAAAAAAAAAAAAAAAAAAAAAAAAAAAAAAAA
GGGGGGGGGGGGDDAAAAAAAAAAAAAAAAAAAAAAAAAAAAAAAAAAAA
JJJJJJJGGGGGGDAAAAAAAAAAAAAAAAAAAAAAAAAAAAAAAAAAAA
JJJJJJJGGGGGGDAAAAAAAAAAAAAAAAAAAAAAAAAAAAAAAAAAAA
JJJJJJJGGGGGGGDAAAAAAAAAAAAAAAAAAAAAAAAAAAAAAAAAAA
JJJJJJJGGGGGGGGDAAAAAAAAAAAAAAAAAAAAAAAAAAAAAAAAAA
JJJJJJJGGGGGGGGDAAAAAAAAAAAAAAAAAAAAAAAAAAAAAAAAAA
JJJJJJJJGGGGGGGDDAAAAAAAAAAAAAAAAAAAAAAAAAAAAAAAAA
JJJJJJJJJGGGGGGGDAAAAAAAAAAAAAAAAAAAAAAAAAAAAAAAAA
JJJJJJJJJGGGGGDGDAAAAAAAAAAAAAAAAAAAAAAAAAAAAAAAAA
JJJJJJJJJJGGGGGDDDDDAAAAAAAAAAAAAAAAAAAAAAAAAAAAAA
JJJJJJJJJGGGGGGDGDDDDAAAAAAAAAAAAAAAAAAAAAAAAAAAAA
JJJJJJJJJJGGGGGGGGGDDAAAAAAAAAAAAAAAAAAAAAAAAAAAAA
JJJJJJJJJJJJGGGGGGDGDAAAAAAAAAAAAAAAAAAAAAAAAAAADD
JJJJJJJJJJJJGGGGGGGDDAAAAAAAAAAAAAAAAAAAAAAAAADGDG
JJJJJJJJJJJJJGGGGGGDDAAAAAAAAAAAAAAAAAAAAAAAADGGGG
JJJJJJJJJJJJJGGGGGGGAAAADDDAAAAAAAAAAAAAAAAADGGGGG
JJJJJJJJJJJJJGGGGGDDADDDDDDDAAAAAAAAAAAAAAADDGGGGG
JJJJJJJJJJJJJGGGGGGDDGGGGGGGDDAAAAAAAAAAAAADDGGGGG
JJJJJJJJJJJJGGGGGGGGGGGGGGGGGGDAAAAAAAAAAADGGGGGGG
JJJJJJJJJJJJGGGGGGGGGGGGGGGGGGDDAAAAAAAAAADGGGGGGG
JJJJJJJJJJJGGGGGGGGGGGGGGGGGGGGDAAAAADAAAADGGGGGGG
JJJJJJGGGGGGGGGGGGGGGGGJJGGGGGGGGDDDDDDDDDDDGGGGGG
MJJJJGGGGGGGGJJJJJJGGGJJJJGGGJGGGGGGDGGGGGDDGGGGGG
JJJJGGGGGGGGGGJJJGJGGJJJJJJGJJGGGGGGGGGGGGGGGGGGGJ
JJJJGGGGGGJGGGJGGGGJJJJJJJJGJJGGGGGGGGGGGGGGGGGGJJ
JJJJGGGGGGGGJJGJJGJJJJJJJJGGGGGGGGGGGGGGGGGGGGGGGJ
JJJJJGGGGGGGJGJJJJJJJJJJJGGGGGJJJJJJJJJGGGGGGGGGJJ
JJJGGGGGGGGGGGJJJJJJJJJJJGGGGGGJJGJJJJJJJJJJJGGGGJ
JJGGGGGGGGGGGGJJJJJJJJJJJGJGGGGGGGJJJJJJJJJJJJJJJJ
JGGGGGGGGJGGJJJJJJJJJJJJJJJGGGGGGJJJJJJJJJJJJJJJJJ
JGGGJJJJJJGGJJJJJJJJJJJJJJGGGGGGGJJJJJJJJJJJJJJJJJ
JJGJJJJJJJJJJJJJJJJJJGJJJGGGGGGGGJJJJJJJJJMJJJJJJJ
GGGJJJJJJJJJJJJJJJJJGGGGJGGGGGGGGJJJJJJJJJMMMJMJMM
JGGJJJJJJJJJJJJJJJJJJJGGGGGGGGGGJJJJJJJJJMMMJJJJMM
JJJJJJJJJJJJJJJJJJJJJJGGGGGGGGGGGJJJJJJJJMMMMJJMMM
JJJJJJJJJJJJJJJJJJJJJJJGGGGGGGGGGGJJJJJJJJMMMMMMMM
JJJJJMJJJJJJJJJJJJJJJJJJJGGGGGGGGGJJJJJJJMMMMJMMMM
JJJJJMMJJJMJJJJJJJJJJJJJJGGGGGGGGGGGJJJJJMMMMMJMMM
JJJJJJJJJJMMJMJJJJJJJJJJJJGGGGGGGGGGJJJJJMMMMMMMMM
JJJJJJJJJJMMMMJJJJJJJJJJJJJJGGGGGGGJJJJJJMMMMMMMPP
JJJJJJJJJJJJJJJJJJJJJJJJJJJJJJGGGGGGJJJJJMMMMMPPPM
JJJJJJJJJJJJJJJJJJJJJJJJJJJJJJJGGGGJJJJJMMMMMMMMMJ
JJJJJJJJJJJJJJJJJJJJJJJJJJJJJJJJGGJJJJJMMMMMMMMMMM
JJJJJJJJJJJJJJJJJJJJJJJJJJJJJJJJJJJJJJMMMMPPPMMPPP
JJJJJJJJJJJJJJJJJJJJJJJJJJJJJJJJJJJJMJMMPPPPPPMMMM
JJJJJJJJJJJJJJJJJJJJJJJJJJJJJJJJJJJJMMMMMPPPPMMMMM
JJJJJJJJJJJJJJJJJJJJJJJJJJJJJJJJJJJMMMMMMPPPPMMPPM
JJJJJJJJJJJJJJJJJJJJJJJJJJJJJJJJJJJMMMPMMPPPPMMPPM
JJJJJJJJJJJJJJJJJJJJJJJJJJJJJJJJJJJJMMMPPPPPPPPPPP
