JJJJJGGJGGGGGGGGGGGJGGGGJJJJGGGJJJJJJJJJJJJJJJJJJJ
GGGJGGGGGGGGGGGGGGJGGGGGGGJGGGGGJJJJJJJJJJJJJJJJJJ
JJJJJGGGGGGGGGGGGGGGGGGGGGGGGGGGGJJJJJJJJJJJJJJJJJ
JGGGGGGGGGGGGGGGGGGGGGGGGGGGGGGGGGGGJGJGJJJJJJJJJJ
GGGGGGGGGGGGGGGGGGGGGGGGGGGGGGGGGGGGGGGGJJJJJJJJJG
GGGGGGGGGGGGGGGGGGGGGGGGGGGGGGGGGGGGGGGGJJJJJJJJJG
GGGGGGGGGGGGGGGGGGGGGGGGGGGGGGDGGGGGGGGGGGJJJJJJJJ
GGGGGGGGGGGGGGGGGGGGGGGGGGGDDDDDDDDGGGGGGGJJJJJJJG
GGGGGGGGGGGGGGGGGGGGGGGGGGDDDDDAADDDDDGGGGJJJJJJJJ
GGGGGGGGGGGGGGGGGGGGGGGGGGDDDDDAAAADAAAGGGJJJJJJGG
GGGGGGGGGGGGGGGGGGGGGGGGGGDDAAAAAAAAAAADGGGJJGGJGG
JGGGGGGGGGGGGGGGGGGGGGGDDDDAAAAAAAAAAAADGGGGGGGGGG
JGGGGGGGGGGGGGGGGGGDDAAAAAAAAAAAAAAAAAAADGGGGGGGGG
JJJJGGGGGGGGGGGGGDAAAAAAAAAAAAAAAAAAAAAAADGGGDGGGD
JJJJJJJJJGGGGGGGGAAAAAAAAAAAAAAAAAAAAAAAAAADAAAAAA
JJJJJJJJJGGGGGGGDAAAAAAAAAAAAAAAAAAAAAAAAAAAAAAAAA
JJJJJJJJJJJGGGGDAAAAAAAAAAAAAAAAAAAAAAAAAAAAAAAAAA
MJJJJJJJJJJGGGDAAAAAAAAAAAAAAAAAAAAAAAAAAAAAAAAAAA
MJJJJJJJJJGGGGGDAAAAAAAAAAAAAAAAAAAAAAAAAAAAAAAAAA
MMJJJJJJJJJGGGGDAAAAAAAAAAAAAAAAAAAAAAAAAAAAAAAAAA
MMJJJJJJJJJGGGGGAAAAAAAAAAAAAAAAAAAAAAAAAAAAAAAAAA
MMJJJJJJJJJGGGGGDAAAAAAAAAAAAAAAAAAAAAAAAAAAAAAAAA
MJJJJJJJJJJJGGGDAAAAAAAAAAAAAAAAAAAAAAAAAAAAAAAAAA
MJJJJJJJJJJJGGGDAAAAAAAAAAAAAAAAAAAAAAAAAAAAAAAAAA
MJJJJJJJJJJJGGGDAAAAAAAAAAAAAAAAAAAAAAAAAAAAAAAAAA
JJJJJJJJJJJGGGGDAAAAAAADDAAAAAAAAAAAAAAAAAAAAAAAAA
JJJJJJJJJJJGGGDAAAAAAADGDDDDAAAAAAAAAAAAAAAAAAAAAA
JJJJJJJJJJGGGGDDAADDDGGGGGGGDAAAAAAAAAAAAAAAAAAAAA
JJJJJJJJJGGGGGGDDDGGGGGGGGGGDAAAAAAAAAAAAAAAAAAAAA
MJJJJJJJGGGGGGGGDGGGGGGGGGGGDDAAAAAAAAAAAAAAAAAAAA
MJJJJJJJJGGGGGGGGGGGGGGJGGGGGGDDAAAAAAAAAAAAAAADDD
MJJJJJJJJGGGGGGGGGGGGGJJGGGGGGGGGDAAAAAAAAAAAAADGG
JJJJJJJJJJJJGGGGGGGJGGGJJJJJJGGGGDAAAAAAAAAAAADGGG
JJJJJJJJJJJJGGJJGJJJGGJJJJJJJGGGGGDAAAAAAAAAAADGGG
JJJJJJJJJJJJGGJJJJJJJGJJJJJJJGGGGGGAAAAAAAAAAAGGGG
JJJJGJJJJJJJJJJJJJJJJJJJJJJJJJGGGGGDDDDAAAAAAADGGG
JJJJJJJJJJJJJJJJJJJJJJJJJJJJJJGGGGGGGGDDAAAAADGGGG
JJJJJJJJJJJJJJJJJJJJJJJJJJJJJJGGGGGGGGDAAAAADGGGGG
JJJJJJJJJJJJJJJJJJJJJJJJJJJJJJJJGGGGGGAAAAADGGGJJJ
JJJJJJJJJJJJJJJJJJJJJJJJJJJJJJJJJGGGGDAAAADGGGGJJJ
JJJJJJJJJJJJJJJJJJJJJJJJJJJJJJJJJJGGGGDAAADGGGGJJJ
JJJJJJJJJJJJJJJJJJJJJJJJJJJJJJJJJJGGGGGGDDDGGGJJJJ
JJJJJJJJJJGGGJJJJJJJJJJJJJJJJJJJJJGGGGGGGGGGGGJJJJ
JJJJJJJJJJJJJJJJJJJJJJJJJJJJJJJJJJJGGGGGGGGGGGJJJJ
JJJJJJJJJJJJJJJJJJJJJJJJJJJJJJJJJJJGJJJGGGGGJJJJJJ
JJJJJJJJJJJJJMMJJJJJJJJJJJMMMMJJJJJJJJJJJJJJJJJJJJ
JJJJJJJJJJJJJJMMMMJMMJJJMMMMMMMJJJJJJJJJJJJJJJJJJJ
JJJJJJJJJJJJJMMMMMMMMJJJMMMMMMMMMJJJJJJJJJJJJJJJJJ
JJJJJJJJJJJJJMMMMMMMMJJJMJMMMMMMMMJJJJJJJJJJJJJJJJ
JJJJJJJJJJJJJMMMMMMMMJMJMJJMMMMMMMJJJJJJJJJJJJJJMM
