MMMMMMJJJJJJGJGGGGGGGGGGGGDAAAAAAAAAAAAAAAAAAAAAAA
MMMMMMMMJJJJJJGGJJJGGGGGGDDAAAAAAAAAAAAAAAAAAAAAAA
MMMMMMMMMJJJJJJGGGGGGGGGGDDAAAAAAAAAAAAAAAAAAAAAAA
MMMMMMMMMJJJJJJJJGGGGGGGGDAAAAAAAAAAAAAAAAAAAAAAAA
MMMMMMMMMJJJJJJJJGGGGGGGDDAAAAAAAAAAAAAAAAAAAAAAAA
MMMMMMMMMJJJJJJJJJGGGGGGGDAAAAAAAAAAAAAAAAAAAAAAAA
MMMMMMMMMJJJJJJJJJGGGGGGGGAAAAAAAAAAAAAAAAAAAAAAAA
MMMMJJMMMMJJJJJJJJJGGGGGGGDAAAAAAAAAAAAAAAAAAAAAAA
JJJJJJJJMMMJJJJJJJJJGGGGGGDAAAAAAAAAAAAAAAAAAAAAAA
JJJJJJJJJMMMMJJJJJJJGGGGGGGGDDAAAAAAAAAAAAAAAAAAAA
JJJJJJJJJMMMMJJJJJJJJGGGGGGGDADAAAAAAAAAAAAAAAAAAA
JJJJJJJJMJMMMMJJJJJJJGGGGGGGGDAAAAAAAAAAAAAAAAAAAA
JJJJJJJMMMMJMJMMJJJJJGGGGGGGGDAAAAAAAAAAADDAAAAAAD
JJJJJJJJMMMJMMJMMJJJJGGGGGGGGGDDAAAAAAAAADDAAAADDD
GJJJJJJJMMJJJJMMMJJJJGGJJGGGGGGDDDDDADDDDDDAAADADD
GJJJJJJJMMJJJMMMMJJJJJJJJJJGGGGGGGGGGGGGDDDDDDDDDD
GGJJJJJJJJJJJMMMMMMMJJJJJJJGGGGGGGGGGGGGGGGGGGGGGG
GGGJJJJJJJJMMMMPPMMMJJJJJJJGGGGGGGGGGGGGGGGGGGGGGG
GGGJJJJJJJJMMMPPPPPMMJJJJJJGGGGGGGGGGGGGGGGGGGGGGG
GGGJJJJJJJMMMPPPPPMMMMMJJJJJGGGGGGGGGGGGGGGGGGGGGG
GGGJJJJJJMMMPPPPPPMMMMMJJJJJGGGGGGGGGGGGGGGGGJJJJJ
GGGJJJJJMMMMMPPPPPMMMMJJJJJJJGGGGGGGGGGGGGGGJJJJJJ
GGGJJJJJMMMPPPPPMMMMMMJJJJJJJJJGGGGGGGGJGGGGJJJJJJ
GGGJJJJMMMMPPPPPPMMMMMJJJJJJJJJJJGGGGJJJJGGGJJJJJJ
GJGJJJMMMMMMMPPPPMMMMMJJJJJJJJJJJJJJJJGGGJGGGJJJJJ
GGJJJJMMMMMMMMMPMMMMMMJJJJJJJJJJJJJJJJGGGJGGGGJJJJ
GJJJJJMMMMMMMMMMMMMMMMJJJJJJJJJJJJJJJJJGGGGGGGGJJJ
JJJJJJJMMMPMMMMMJJJJJJMJJJJJJJJJJJJJJJJJGGGGGGJJJJ
JJJJJJJMMMPPMMMJJJJJJJJJJJJJJJJJJJJJJJJJGGGJJJJJJJ
JJJJJJMMMMPPPMMJJJJJJJJJJJJJJJJJJJJJJJJJGGJJJJJJJJ
JJJJJJMMMPPPMMMJJJJJJJJJJJJJJJJJJJJJJJJJJJJJJJJJJJ
JJJJJJMMMMMPMMJJJJJJJJJJGGGGJJJJJJJJJJJJJJJJJJJJJJ
JJJJJJMMMMMMMMMJJJJJJJGGGGGGGJJJGJGJJJJJJJJJJJJJJJ
JJJJJJJMMMMJJJMJJJJJJGGGGGGGGGGGGGGGJJJJGJJJJJJJJJ
JJJJJJJMMJJJJJMMJJJJGGGGGGGGGGGGGGGGGJJJGGGJJJJGGG
JJJJJJMMJJJJJJJJJJJJJGGGGGGGGGGGGGGGGGGGGGGGGGGGGG
JJJJJJJJJJJJJJJMJJJJJJGGGGGGGGGGGGGGGGGGGGGGGGGGGG
MMJJJJJJJJJJJJJMJJJJJJGGGGGGGGGGGGGGGGGGGGGGGDGGGG
JMMMJJMJJJJJJJJMJJJJJJGGGGGGGGDGGGGGGGGGGGGGDDGGGG
MMMJJJJJJJJJJJJJJJJJJJJGGGGGDDDDGGGGGGGGGDDDGDGGGG
JMMMJJJJJJJJJJJJJJJJJJJGGGGGDDDDGGGGGGGDDDADDDGDGG
MJJMJJJJJJJJJJJJJJJJJJJGGGGDDDDDDDGGGGGDDAAAADDDDD
MJMJJJJJJJJJJJJJJJJGJGJGGGDDDDDDDDGGGDDDAAAAADAADD
MJJJJJJJJJJJJJJJJJGGGGGGGDDDDDDDDDGGDDAAAAAAAAAAAD
JJJJJJJJJJJJJJJJGGGGGGGGGDDDDDDDDDDDDDDAAAAAAAAAAA
JJMJJJJJJJJJJGJGGGGGGDGDDDDDDDDDDDDDDDDDAAAAAAAAAD
MJMJJJJJJJJJJGGGGGGGDDDDDDDDDDDDDDDDDGDDDDDAAAAADD
MMMJJJJJJJJJGGGGGGGDDDDDDDDDDDDDDDDDGGGDGGGDADADGG
MMMJJJJJJJJJGGGGGDGGDDDDDDDDDDDDDDDDDGGGGGGGDDDDGG
MJJJJJJJJJJJGGGGGDGDDDDDDDDDDDDDDDDDDGGGGGGGGGDGGG
