JMMJMMMMMMPMMMMPPMPPPMMMMMMJJJJJJJJJJJJJJJJGGGGGGG
JMMJMMMMMPMMMMPMMMMMPMMMMJJMJJJJJJJJJJJJJJGGGGGGGG
JMJMMMMMMMMJMMPMMMMMMMMMMMMMJJJJJJJJJJJJJGGGGGGGGG
JJJMMMMMMPMJMMMMMMJJMJMMMJJJJJJJJJJJJJJJJGGGGGGGGG
JJMMMMPPMMMMMJMMMJJMMJMMJJJJJJJJJJJJJGJGGGGGGGGGGG
JJJMJMMMMMMMMMJMMMMMMMMJJJJJJJJJJJJJGGGGGGGGGGGGGG
JMJJMMMMMMMMPMMMMMMMMMJJJJJJJJJJJJJGGGGGGGGGGGGGGG
JJJMMMMMJMMMMJJJMJMMMJJJJJJJJJJGGJGGGGGGGGGGGGGGGG
JJJMJJJJJJMMMJJMJJJJJJJJJJJJJGGGGGGGGGGGGGGGGGGGGG
JJJJJJJJJJJMJJJJJJJJJJJJJJJJJGGGGGGGGGGGGGGGGGGGGG
MJJJJJJJGJJJJJMJJJJJJJJJJJJJJGGGGGGGGGGGGGGGGGGGGG
JJJJJJGGGGJJJJJJJJJJGGGGGJJJJGGGGGGGGGGGGGGGGGGGGG
JGJJJJGGJGGJJJJJJJGGGGGGGGJJJGGGGGGGGGGGGGGGGGGGGG
GJJJJJGGGJJJJJJJJJGGGGGGGGJJJGGGGGGGGGGGGGGGGGGGGG
JJJJJJJJJJJJJJJJJJJGGGGGGGGJGGGGGGGGGGGGGGGGGGGGGG
JJJJJJJJJJJJJJJJJJJGJJGGGGJGGGGGGGGGGGGGGGGGGGGGGG
JJJJJJJJJJJJJJJJJJJJJGGGGGGJJJGGGGGGGGGGGGGGGGGGGG
JJJJJJJJJJJJJJJJJJJGGGGGJJGGGJJGGGGGGGGGGGGGGGGGGG
JJJJJJJJJGJJJJJJJJGGGGGGGGGGGJJGGGGGGGGGGGGGGGGGGG
JJJJJGGGGJJJJJJJJJJGGGGGGGGGGJJJJGGJGGGGGGGGGGGGGJ
JJGGGGJJJJJJJJJJJJJGGGGGGGGGGJJJJGJGGGGGGGGGGGGGGG
GGGGGJJJJJJJJJJJJJJGGGGGGGGGGGJJJGGGGGGGGGGGGGGGGG
GGGGGJJJJJJJJJJJJJJGGGGGGGGGGGGGGGGGGGGGGGGGGGGGGG
GGGGGGJJJJJJJJJJJJJGGGGGGGGGGGGGGGGGGGGGGGGGGGGGGJ
GGGGGGJJJJJJJJJJJJJGGGGGGGGGGGGGGGGGGGGGGGGGGGJJJJ
GGGGGGGJJJJJJJJJJJGGGGGGGGGGGGGGGGGGGGGGGGGGJJJJJJ
GGGGGGJJJJJJJJJJGGGGGGGGGGGGGGGGGGGGGGGGGGGGJJJJJJ
JGJJJJJJJJJJJJJJJJGGGGGGGGGGGGGGGGGGGGGGGGGGJJJJJJ
GJJJJJJJJJJJJJJJJJGGGGGGGGGGGGGGGGGGGGGGJJJJJJJJJJ
JJJJJJJJJJJJJJJJJJGGGGGGGGGGGGGGGGGGGGGGJJJJJJJJJJ
JJJJJJJJJJJJJJJJJJGGGGGGGGGGGGGGGGGGGGGGJJJJJJJJJJ
JJJJJJJJJJJJJJJJJGGGGGGGGGDGGGGGGGGGGGGGGJJJJJJJJJ
JJJJJJJJJJJJJJJJJJGGGGGGGDDDGGGGGGGGGGGJJJJJJJJJJJ
JJJJJJJJJGGGJJJJJJGGGGGGDGDDDGGGGGGGGGJJJJJJJJJJJJ
JJJJJJJJGGGGGGGJJGGGGGDAADDDDGGGGGGGGGJJJJJJJJJJJJ
JJJJJJJGGGGGGGGGGGGGGDDAAAAAADGGGGGGGJJJJJJJJJJJJJ
JJJJJJGGGGGGGGGGGGGGGGDAAAAAADGGGGGGGJJJJJJJJJJJJJ
JJJJJGGGGGGGDGGGGGGGDDDDAAAAADGGGGGGGJJJJJJJJJJJJJ
JJJJGGGGGGDDDDDDDDDDADAAAAAAAADGGGGGGGJJGGGJGJJJJJ
GGJGGGGGGDDAAAAAADAAAAAAAAAAAAADGGGGGGGGGGGGGGJGGJ
GGGGGGGGGAAAAAAAAAAAAAAAAAAAAAAADGGGGGGGGGGGGGGGGG
GGGGGGGGGAAAAAAAAAAAAAAAAAAAAAAADGGGGGGGGGGGGGGGGG
GGGGGGGDDAAAAAAAAAAAAAAAAAAAAAAAADGGGGGGGGGGGJGGGG
GGGGDDDDAAAAAAAAAAAAAAAAAAAAAAAAADGGGGGGGGGGGGGGGG
GGGGDDDDAAAAAAAAAAAAAAAAAAAAAAAAADGGGGGGGGGGGGGGGG
GGDDAAAAAAAAAAAAAAAAAAAAAAAAAAAAADGGGGGGGGGGGGGGGG
GDDAAAAAAAAAAAAAAAAAAAAAAAAAAAAADGGGGGGGGGGGGGGGGG
DDAAAAAAAAAAAAAAAAAAAAAAAAAAAAAADGGGGDGGGGGGGGGGGG
DDAAAAAAAAAAAAAAAAAAAAAAAAAAAAAADGGGDDDGGGGGGGGGGG
DDAAAAAAAAAAAAAAAAAAAAAAAAAAAAAADGGDDDDDGGGGGGGGGG
