GGGGGGGGGGDDDDDDDDDDDGGGGGGGGGDAAAAAAAAAAAAAAAADDD
JJJGGGGGGDDDDDDDDDDDGGGGDDGGGDAAAAAAAAAAAAAAAAAAAA
JJGGGGGGDDDDDDDDDDDDGGGGGDDDAAAAAAAAAAAAAAAAAAAAAA
JJJGGGGDDDDDDDDDDDDDDDDDDADAAAAAAAAAAAAAAAAAAAAAAA
JJJJGGGGDDDDDDDDGDDDDAAAAAAAAAAAAAAAAAAAAAAAAAAAAA
JJJJGGGGDDDDDDDGGGGGGDAAAAAAAAAAAAAAAAAAAAAAAAAAAA
JJJGGGGGGGGGGDGGGGGGDDAAAAAAAAAAAAAAAAAAAAAAAAAAAA
JJJGGGGGGGGGGGGGGGGDDADAAAAAAAAAAAAAAAAAAAAAAAAAAA
JJJGGGGGGGGGGGGGGGGDDADAAAAAAAAAAAAAAAAAAAAAAAAAAA
JJGJJGGGGGGGGGGGGGGGDDAAAAAAAAAAAAAAAAAAAAAAAAAAAA
JJJJJJJGGGGGGJJJGGGGGDAAAAAAAAAAAAAAAAAAAAAAAAAAAA
JJJJJJJJJGGGJJJJJGGGGDDAAAAAAAAAAAAAAAAAAAAAAAAAAA
JJJJJJJJJJJJJJJJJJJGGGDAAAAAAAAAAAAAAAAAAAAAAAAAAA
JJMMJJJJJJJJJJJJJJJJGGGDAAAAAAAAAAAAAAAAAAAAAAAAAA
JJJMJMJJJJJJJJJJJJJJJGGGAAAAAAAAAAAAAAAAAAAAAAAAAA
JJJJMJJJJJJJJJJJJJJJJJGGGDDAAAAAAAAAAAAAAAAAAAAAAA
JJJJJJJJJJJMJJJJJJJJJJGGGDDAAAAAAAAAAAAAAAAAAAAAAA
MJJJJJMJJJJJJJJJJJJJJJJGGGDAAAAAAAAAAAAAAAAAAAAAAA
JMJJJJJJJJJJJJJJJJJJJJJGGGGDAAAAAAAADDAAAAAAAAAAAA
MMMJJMJMJMJJJJJJJJJJJJJJGGGGDDAAADDDDDDAAAAAAAAAAA
MMJMMJMMMMMJJJJMJJJJJJJJGGGGGDDAADDDDAAAAAAAAAAAAA
MMMMJMMJJJMJJJJJJJJJJJJJGGGGGGDAADDDDDDAAAAAAAAAAA
MMMJMMMMMMJJJJMJJMJJJJJJJGGGGDDAAADDDDDGDAAAAAAAAA
MJJMMMMMMMJJJMJJMMJJJJJJJJGGDDDAAADDDDGGGDDAAAAADD
JJMMJMMMMMMJJMMMMJMJJJJJJJGGGAAAAADDDGGGGDDAAAAADD
JJMJJJJJMJJJMMMMJJMMJJJJJJGGGAAAAADGGGGGGGGDAAADDG
JMJJJJJMJJJMMMMMMMMMMJJJJJGGGDAADDGGGGGGGGGGDDDDGG
JJMMMJJJMMJMMMMJMMMMMJJJJJJGGGGDGGGGGGGGGGGGDDGGGG
JMMMMMJMJMMMPMMMMMMMMMMJJJJJGGGGGGGGGGGGGGGGGGGGGG
MMMMJJJJJMMPPMMPMMPPMMMMJJJJJGGGGGGGGGGGGGGGGGGGGG
MMMMMJJJMMMPPPPPPPPPMMMMJJJJJJGGGGGGGGGJGGGGGGGGGJ
JMPMMMMMMPPPPPPPPPPPPPMMJJJJJJGGGJJGGGJJJGGGGGGGGG
MPMMPMPPPMPPPPMPPPPPPPMMJMJJJJGGJJJJJJJJJGGGGGGGGG
PPPPPMPPPMMPPPPPPPPPPPPMMJJJJJGJJJJJJJJJJJGGGGGGGG
PPPPMPPMPPPPPPMMPPPPPMMMMMJJJJJJJJJJJJJJJJGGGGGGGG
PPPPPMPPPPPPPMMMPPPPMPMMJJJJJJJJJJJJJJJJJJGGGGGGGG
PPPPPPPPPPPPMMPJPPPPMMMJJJJMJJJJJJJJJJJJJJGGGGGGGG
PPPPPPPPPPPPPPMMJMPPMMMJJJMMMJMJJJJJJJJJJJGGGGGGGG
PPPPPPPMPPPPPPMPPJMMMMMMMMJMMJJJJJJJJJJJJGGGGGGGGJ
PPPPPMPPPPPMPPMPMJJJMMMMMMMJJJMJJJJJJJJJJJGGGGGGGJ
PPPPPPMMJMPPPPPMPMJJMMMMMMMJJJMMMJJJJJJJJJJJGGGJJJ
PPPPPPMMMPMMMPPPMMJJJMMMMMJJJJMJJJMJJJJJJJJJJGGJJJ
PPPPPJJMMJJPMPMPMJMJMMMMMMJJJJMJJJMJMMMJJJJJJJJGJJ
PPPPMMMMPPMPMMMMMJJJJMMJJJJMMJJJMMMMMJJJJJJJJJJJJJ
MPPPPMMPPPPMJPPPMMMJJJMJMMJMMMMJMMMMJJJJJJJJJJJJJJ
MPPPPPPPPPPMJMPMMMMMJMJJJPPMPMMMMJMMJJJJJJJJJJJJJJ
MMPPPPPPPPPPMMPMMMMJJMMMMPPPMMMMMJJJJJJJJJJJJJJJJJ
MPPMPPMMPMMMJJMMJJJJJJMMMPMMMMMMMJJJJJJJJJJJJJJJJJ
PPMJMJMMMMMJJMMMJJMJMMMMMMMMJJJJJJJJJJJJJJJJJJJJJJ
PMMMJMJJJMMJJJMMJJJMMMMMMMMMJJJJJJJJJJJJJJJJJJJJJJ
