DDDDDDDDDDDDDDDDDDDDDDGGDGGGGGGGGGGGGGGGJJJJJGJJJJ
DDDDDDDDDDDDDDDDDDDDDDDGDDDDDDDGGGGGGGGGGGGJJGGGGG
GDDDDDDDDDDDDDDDDDDDDDDDDDDDDDDDDDDGGGGGGGGJJJGGGG
GGDDDDDDDDDDDDDDDDDDDDDDDDDDDDDDDDDDDDGGGGGGGGJGGG
GGDDDDDDDDDDDDDDDDDDDDDDDDDDDDDDDDDDDDGGGGGGGGGGGG
GGGDDDDDDDDDDDDDDDDDDDDDDDDDDDDDDDDDDDDDDDGGGGGGGG
GGGDDDDGGDDDDDDDDDDDDDDDDDDDDDDDDDDDDDDDDDDDGGGGGG
JGGGGDGGGGGGDDDDDDDDDDDDDDDDDDDDDDDDDDDDDDDGGGGGGG
GGGGGGGGGGGGDDDDDDDDDDDDDDDDDDDDDDDDDDDDDDDGGGGGGG
GGGGGGGGGGGDDDDDDDDDDDDDDDDDDDDDDDDDDDDDDDDDGGGGGD
GGGGGGGGGGGGDGDDDDDDDDDDDDDDDDDDDDDDDDDDDDDDDDGGDD
GGGGGGGGGGGGGGGDDDDDDDDDDDDDDDDDDDDDDDDDDDDDDDDDDD
GGGGGGGGGGGGGGGGGGDDDDDDDDDDDDDDDDDDDDDDDDDDDDDDDD
JGGGGGGGGGGGGGGGGGGGDDDDDDDDDDDDDDDDDDDDDDDDDDDDDD
JGGGGGGGGGGGGGGGGGGGGGDDDDDDDDDDDDDDDDDDDDDDDDDDDD
JJJJJJGGGGGGGGGGGGGGGGDDDDDDDDDDDDDDDDDDDDDDDDDDDD
JJJJJJJJJJGGGGGGGGGGGGGGDDDDDDDDDDDDDDDDDDDDDDDDDD
JJJJJJJJJGGGGGGGGGGGGGGGDDDDDDDDDDDDDDDDDDDDDDDDDD
JJJJJJJJJJJJJJJJGGGGGGGGGDDDDDDDDDDDDDDDDDDDGDDDDD
JJJJJJJJJJJJJJJJJJGGGGGGGDDDDDDDDDDDDDDDDGGGGGGGDD
JJJJJJJJJJJJJJJJJJJGGGGGGGDDDDDDDDDDDDDDDGGGGGGGGD
JJJJJJJJJJJJJMJJJJJJJGGGGGDDDDDDDDDDDDGGGGGGGGGGGG
JJJJJJJJJJJJJMMJJJJJJJGGGGGGGGGGGDGGGGGGGGGGGGGGGD
JJJJJJJJJMJJMMMJJJJJJJGGGGGGGGGGGGGGGGGGGGGGGGGGDD
JJJJJJJJJMMMMMJJMJJJJJGGGGGGGGGGGGGGGGGGGGGGGGGGGD
JJJJJJJJJJMMMJJJJJJJJJGGGGGGGGGGGGGGGGGGGGGGGGGGDD
JJJJJJJJJJJMMMMJJJJJJJJGGGGGGGGGGGGGGGGGGGGGGGGGDD
JJJJJJJJJJJMMMMMJMMJJJJJGGGGJJJGGJJGGGGGGGGGGGGGDD
JJJJJJJJJJJJMMMMMMJJJJJJJJJJJJJGJJJJJJJGGGGGGGGGDD
JJJJJJJJJMMMMMJJJJJJJJJJJJJJJJJJJJJJJJJJJJJGGGGGDD
JJJMMJJMMMMMMMMJJMJJJJJJJJJJJJJJJJJJJJJJJJJJJGGGGD
JJJMMMMMMMMMMJJJJMMJJJJJJJJJJJJJJJJJJJJJJJJJJGGGGD
JMJMMMMMMJMMJJJJJJJJJJJJJJJJJJJMJJJJJJJJJJJJJGGGGG
JJJMJMMMMJJJJJJJJJJJJJJJJJJJJMJJJJJJJJJJJJJJJGGGGG
JJMMMMMMMMJJJJJJJJJJJJJJJJJJJMMMJJJJJJJJJGGGGGGGGG
MMMMMMMJMJJJJJJJMJJJJJJJJJJJMMMMJJJJJJJJJGGGJGGGGG
JMJMMMMMMMMJJMJMMJJJJJJJJJJJMMMMJJJJJJJJJGGGGGGGGG
JMJJJMMMMMJJJMMMMJJGJJJJJJJJMMMMJJJJJJJJJGJGJGGGGG
MMJMMPPPPPMMMJMMMJJJJGJJJJJJMJJJJJJJJJJJJJJJJGGGGG
MMJMPPPPPPMMMMMMMJJGJJJJJJJJJJJJJJJJJJJJJJJJJJGGGG
PPPMMMPPPMPPPMMMMJJJJJJJJJJJJJJJJJJJJJJJJJJJJJJGGG
MMPPJJMMPPPPPPMMMJJJJJJJJJJJJJJJJJJJJJJJJJJJJJJGGG
MMMJMMMJMMPPPMMMJJJJJJJJJJJJJJJJJJJJJJJJJJJJJJGGGG
JMMPPPPMMMPPPMMMJMMJMJJMMMMMMJJJJJJJJJJJJJJGGGGGGG
MMPPMMPMMMPMMMMJJJMMMMMMMMMJJMJJMJJJJJJJJJGGGGGGGG
MMMMMPPMMPPPPMMMJJJMMMMMMMMMMMMJJJJJJJJJJJGGGGGGGG
PPMMMPPPPPPPPPMMJMJJMPPPMMMMMMMMJJJJJJJJGGGGGGGGGG
PMMMPPPPPPPPPPMMJJJJJMMMMMMMMMMJJJJJJJGGGGGGGGGGGG
PPPPPPPPPPPPPPPPMMJMMMPMMMMPMMMMMJJJGJGGGJJGGGGGGG
PPPPPPPPPPPPPPPPPMMMPMMPMMMMPPMMMJJJGJJJGGGGGGGGGG
