JGGGGGGGGGGGGGGGGGGGGGGGGGJJJJJJJJJJMMMMMMMPPPPPPM
JJGGGGGGGGGGGGGGGGGGGGGGGGGJJJJJJJJJMJMMMMMMPPPPPM
JJJGGGGGGGGGGGGGGGGGGGGGGGGGJJJJJJJJJJJMMMMMPPPPPM
JJJGGGGGGGGGGGGGGGGGGGGGGGGGJJJJJJJJJJMMMMMMPMPPPM
JJGGGGGGGGGGGGGGGGGGGGGGGGGGJJJJJJJJJJJJJMMMMMPPPM
JJGGGGGGGGGGGGGGGGGGGGGGGGGGJJJJJJJJJJJMMMMMMMMPPM
JGGGGGGGGGGGGGGGGGGGGGGGGGGGGGJJJJJJJJJMMMMMJMMPMM
GGGGGGGGGGGGGGGGGGGGGGGGGGGGGGJJJJJJJJJJJJMMMMMPMM
GGGGGGGGGGGGGGGGGGGGGGGGGGGGGGJJJJJJJJJJJJMJMMMMMM
GGGGGGGGGGGGGGGGGGGGGGGGGGGGGGGGJJJJJJJJJJJMMMMMMM
GGGGGGGGGGGGGGGGGGGGGGGGGGGGGGGGGGJJJGJJJJJJMJJJMM
GGGGGGGGGGGGGGGGGGGGGGGGGGGGGGGGGGGGGGJJJJJJMJJJMM
GGGGGGGGGGGGGGGGGGGGGGGGGGGGGGGGGGGGGJJJJJJJJJJMMM
GGGGGGGGGGGGGGGGGGGGGGGGGGGGGGGGGGGGGJJJJJJJJJJMJJ
GGGGGGGGGGGGGGGGGGGGGGGGGGGGGGGGGGGGGJJJJJJJJJJJJJ
GGGGGGGGGGGGGGGGGGGGGGGGGGGGGGGGGGGGJJJJJJJJJJJJJJ
GGGGGGGGGGGGGGGGGGGGGGGGGGGGGGGGGGGJJJJJJJJJJJJJJJ
GGGGGGGGGGGGGGGGGGGGGGGGGGGGGGGGGGGGJJJJJJJJJJJJJJ
GGGGGGGGGGGGGGGGGGGGGGGGGGGGGGGGGGGGJJJJJJJJJJGJJJ
GGGGGGGGGGGGGGGGGGGGGGGGGGGGGGGGGGGGJJJJJJJJJJJJJJ
GGGGGGGGGGGGGGGGGGGGGGGGGGGGGGGGGGJJJJJJJJJJJJJGGJ
GGGGGGGGGGGGGGGGGGGGGGGGGGGGGGGGGJJJJJJJJJJJJJGGGG
JJGGGGGGGGGGGGGGGGGGGGGGGGGGGGGGGJJJJJJJJJJJJGGGGG
JJGGGGGGGGGGGGGGGGGGGGGGGGGGGGGGGJJJJJJJJJJGGGGGGG
JJJGGGGGGGGGGGGGGGGGGGGGGGGGGGGGGGJJJJJJJGGGGGGGGG
JJJGGGGGGGGGGGGGGGGGGGGGGGGGGGGGGGJJJJGGGGGGGGGGGG
JJJGGGGGGGGGGGGGGGGGGGGGGGGGGGGGGGGGJGGGGGGGGGGGGG
JJJGGGGGGGGGGGGGGGGGGGGGGGGGGGGGGGGGGGGGGGGGGGGGGG
JJJGGGGGGGGGGGGGGGGGGGGGGGGGGGGGGGGGGGGGGGGGGGGGGG
JJJGGGGGGGGGGGGGGGGGGGGGGGGGGGGGGGGGGGGGGGGGGGGGGG
JJJJJGGGGGGGGGGGGGGGGGGGGGGGGGGGGGGGGGGGGGGGGGGGGG
JJJJJJJGGGGGGGGGGGGGGGGGGGGGGGGGGGGGGGGGGGGGGGGGGG
JJJJJJJGGGGGGGGGGGGGGGGGGGGGGGGGGGGGGGGGGGGGGJJGGG
JJJJJGJGGGGGGGGGGGGGGGGGGGGGGGGGGGGGGGGGGGGGJJJJGG
JJJJJGGGGGGGGGGGGGGGGGGGGGGGJGJGGGGGGGGGGGGGJJJJGJ
JJJGGGGGGGGGGGGGGGGGGGGGGGGJJJJJGGGGGGGGGGGGJJJJJJ
JJGGGGGGGGGGGGGGGGGGGGGGGJJJJJJJJGJGGGGGGGGJJJJJJJ
JJGGGGGGGGGJGGGGGGGGGGGGGJJJJJJJJJJJGGGGGGJJJJJJJJ
JJGGGGGGGGGJGGGGGGJJGGGGJJJJJJJJJJJJJGGGGGJJJJJJJJ
JJGGGJGGGGJGJGGGGJJJJGJJJJJJJJJJJJJJJJJJGJJJJJJJJJ
JJGGJJJGGGJJGGGGJJJJJJJJJJJJJJJJJJJJJJJJJJJJJJJJJJ
JJJJJJJJGGJJGGGGJJJJJJJJJJJJJJJJJJJJJJJJJJJJJJJJJJ
JJJJJJJGGGGGGGGGJJJJJJJJJJJJJJJJJJJJJJJJJJJJJJJJJJ
JJJJJJGGGGGGGGGGJJJJJJJJJJJJJJJJJJJJJJJJJJJJJJJJJJ
JJJJJJGGGGGGGGGGJJJJJJJJJJJJJJJJGJJJJJJJJJJJJJJJJJ
GGJJGGGGGGGGGGGJJJJJJJJJJJJJJJJJJJJJJJJJJJJJJJJJJJ
GGGGGGGGGGGGGGGGJJJJJJJJJJJJJJJJJJJJJJJJJJJJJJJJJJ
GGGGGGGGGGGGGGGGJJJJJJJJJJJJJJJJJJJJJJJJJJMJJJJJJJ
GGGGGGGGGGGGGGGGGJJJJJJJJJJJJJJJJJJJJJJJJJMMMJJJJJ
GGGGGGGGGGGGGGGGGGGJJJJJJJJJJJJJJJJJJJJJJJMMMMJMMM
