PPPPPPPPPPMMMJJJJJGGGGGGGGGGGJGGGJGGGGGGGGGGGGDGDA
PPPPPPPPPPMMMMJJJJJGGGGGGGGGGGGGGGGGGGGGGGDDDDDAAA
PPPPPPPPPMMMMJJJJJJJJJGGGGGGGGGGGGGGGGGDADAAAAAAAA
PPPPPPPPPMMMJJJJJJJJJJGGGGGGGGGGGGGGGGDAAAAAAAAAAA
PPPPMPPPMMJJJJJJJJJJJJJGGGGGGGGGGGGGDDDAAAAAAAAAAA
PPPMMMMMMMJJJJJJJJJJJJJGGGGGDDDDDADDAAAAAAAAAAAAAA
MMMJMMMMMJJJJJJJJJJJJJJJGGGDAAAAAAAAAAAAAAAAAAAAAA
MMJJMMMMMJJJGJGJJJJGJJJGGGGDAAAAAAAAAAAAAAAAAAAAAA
MJJMJMMJJJJJGGGGGGGGGGGGGGGDAAAAAAAAAAAAAAAAAAAAAA
MMMMJMJJJJJJGGGGGGGGGGGGGDDAAAAAAAAAAAAAAAAAAAAAAA
MMMMJJJJJJJGGGGGGGGGGGGGDAAAAAAAAAAAAAAAAAAAAADAAA
MMMJJJJJJJJGGGGGDDDGGGGDDAAAAAAAAAAAAAAAAAAAADDAAD
MJJJJMJJJJGGGGDDDAAAAAAAAAAAAAAAAAAAAAAAAAAAADDDDD
JJJJJJJJJJGGGGDGGDAAAAAAAAAAAAAAAAAAAAAAAAAADDGDDD
JJJJJJJJJJGGGGGDDAAAAAAAAAAAAAAAAAAAAAAAAAAADDGDDD
JJJJJJJJJJJGGGGGDDAAAAAAAAAAAAAAAAAAAAAAAAADDDGGDD
JJJJJJJJJJJGGGGGDDAAAAAAAAAAAAAAAAAAAAAAAAADGGGGGG
JJJJJJJJJJJJGGGGGDAAAAAAAAAAAAAAAAAAAAAAAAADGGGGGG
JJJJJJJJJJJJJJGGGGDAAAAAAAAAAAAAAAAAAAAAAAADGGGGGG
JJJJJJJJJJJJJJGGGDDAAAAAAAAAAAAAAAAAAAAAAAAADGGGGG
JJJJJJJJJJJJJJGGGGDAAAAAAAAAAAAAAAAAAAAAAAAAADGGGG
JJJJJJJJJJJJJJJJGGDDAAAAAAAAAAAAAAAAAAAAAAAAADGGGG
JJJJJJJJJJJJJJJJGGGDAAAAAAAAAAAAAAAAAAAAAAADDDGGGG
JJJJJJJJJJJJJJJJGGGGDAAAAAAAAAAAAAAAAAAAAAADDGGGGG
JJJJJJJJJJJJJJJJJGGGGDAAAAAAAAAAAAAAAAAAAAADGGGGGG
GGJJJJJJJJJJJJJJJJGGGGDAAAAAAAAAAAAAAAAAAADGGGGGGG
JJJJJJJJJJJJJJJJJJJGGGGAAAAAAAAAAAAAAAAAADGGGGGGGG
JJJJJJJJJJJJJJJJJJJJGGGAAAAAAAAAAAAAAAADDDGGGGGGGG
JJJJJJJJJJJJJJJJJJJGGGGDAAAAAAAAAAAAAAADGGGGGGGGGG
JJJJJJJJJJJJJJJJJJJGGGGAAAAAAAAAAAAAAAADGGGGGGGGGG
JJJJJJJJJJJJJJJJJGGGGGGAAAAAAAAAAAAAAADGGGGJJGGGGG
JJJJJJJJJJJJJJJJGGGGGGGAAAAAAAAAAAAAAADGGGJJJJGGGG
JJJJJJJJJJJJJJJJGGGGGGGDAAAAAAAAAAAAAADGGGJJJJJGJJ
JMMMJJJJJJJJJJJGGGGGGGDDAAAAAAAAAAAAAADGGGJJGJJJJJ
JMMMMJJJJJJJJJJGGGGGGGDDDAAAAAAAAAAAADGGGGGGGJJJJJ
JJMMMJMJJJJJJJJJGGGDDGDGGDAAAAAAAAAADADGGGGGJJJJJJ
JMMMMMJJJJJJJGGGGGGDDDDDDDDAAAAADDDDDDDGGGGGGJGJJJ
JMMMMMJJJJJJJGGGGGDDDDDDDDDAAAADDDDDDGGGGGGGGGGJJJ
JMMMMMJJJJJJGGGGGGGDDDDDDDAAAAADDDDDDGGGGGGGGGGJJJ
JMMMMJJJJJJJJGGGGGDDDDDDGDDAADDDDDDGGGGGGGGGGGJJJJ
MMMMMMJJJJJJJGGGGGDDDDDDGGDDDDDGGGGGGGGGGGGGGGGJJJ
MMMMMMMJJJJJJGGGGGGGGDDDGDDDDDGGGGGGGGGGJGGGGGJJJJ
MMMMMMMJJJJJJGGGGGGGGGDDGDDDDDGGGGGGGGJJJJJJGJJJJJ
JMMMMMMJJJJJJGGGGGGGGGGDGDDDGGGGGGGGGJJJJJJJJJJJJJ
MMMMMMMMJJJJJGGGGGGGGGGGDDDDDGGGGGJJJJJJJJJJJJJJJJ
JMMMJMMMJJJJJJGGGGJJJGGGDDDDDGGGGGJJJJJJJJJJJJJJJJ
JMMJJMMMJJJJJJJJJJJJJGGGGDDDDDDGGGGGJJJJJJJJJJJJJJ
JJJJJMMJJJJJJJJJJJJJJJGGGDDDDDDGGGGGGJJJJJJJJJJJJJ
JJJJMMMJJJJJMJJJJJJJJJJGGDDDDDGGGGGGGJJJJJJJJJJJJJ
JMJJJJMMMJJJJMJJJMMJJJJGGGDDDDGGGGGGGJJJJJJJJJJJJJ
