MMMMPPPPMPPPPPMMPPPPMMMMMMMMMMMJJJJJJJJJJGGGGGDAAA
MMMMMPPMMMMPPMPMMMMMPPMMMMMMMMJJJJJJJJJJJGGGGGDAAA
MMMMMPMMMMMMMMMMMMMMPPPMMMMMMMJJJJJJJJJJJGGGGGAAAA
MMMMMPPMMMMMMMMMMMMMPPMMMMMMJJJJJJJJJJJJGGGGGDAAAA
MJJMMPMMMJMMMMJMMMMMMMMMMMMMJJJJJJJJJJJJJGGGGDAAAA
JJMMMMMMMMJMMJJMJMJMMMMMMMMMJJJJJJJJJJJJJJGGGGDAAA
JJMMMMMMMMMJJJJJJJJJMMMMMMMMJJJJJJJJJJJJJGGGGGGAAA
JJJMMMMMMMMJJJJJJJJMMMMMMMMMJJJJJJJJJJJJJGGGGGGDAA
JMJMMMMMMMMMJJJJJJJJJMMJMMMJJJJJJJJJJJJJJGGGGGGDAA
JJMMMMJJJJJJJJJJJJJJJMMJMJJJJJJJJJJJJJJGGGGGGGGDAA
JJMJJJJJJJJJJJJJJJJJJMJJMJJJJJGGJJJJJJGGGGGGGGDDAA
JJJJJJJJJJJJJJJJJJJJJJJJJJJJJJGGGGGJGGGGGGGGGGDAAA
JJJJJJJJJJJJJJJJJJJJMJJJJJJJJJJGGGGGGGGGGGGDDAAAAA
JJJJJJJJJJJJJJJJJJJJJJJJJJJJJJGGGGGGGGGGDAAAAAAAAA
JJJJJJJGJJJJJJJJJJJJJJJJJJJJJGGGGGGGGGDDAAAAAAAAAA
JJJJGGGGJJJJJJJJJJJJJJJJJJJJJGGGGGGGGGDAAAAAAAAAAA
JJGGGGGGGJJJJJJJJJJJJJJJJJJJGGGGGGGDDAAAAAAAAAAAAA
JJGGGGGGGJJJJJJJJJJJJJJJJJJGGGGGGGDDAAAAAAAAAAAAAA
JJJJGGGGGJJJJJJJJJJJJJJJJGGGGGGGGGDDAAAAAAAAAAAAAA
JJJJGGGGGGJJJJJJJJJJJJJJGGGGGGDDDAAAAAAAAAAAAAAAAA
JJJJGGGGGGGJJJJJJJJJJJGGGGGDDDAAAAAAAAAAAAAAAAAAAA
JJJGGGGGGGGJJJJJJJJJGGGGGGGGDAAAAAAAAAAAAAAAAAAAAA
GJJGGGGGGGGJJJJJJGGGGGGGDDDDDAAAAAAAAAAAAAAAAAAAAA
GGGGGGGGGGGGJJJJJGGGGGGGDDDDAAAAAAAAAAAAAAAAAAAAAA
GGGGGGGGGGGGJJJJGGGGGGGGDDDAAAAAAAAAAAAAAAAAAAAAAA
GGGGGGGGGGGGJGGGGGGGGGGGDDDAAAAAAAAAAAAAAAAAAAAAAA
GGGGGGGGGGGGGGGGGGGGGGGGGDAAAAAAAAAAAAAAAAAAAAAAAA
GGGGGGGGGGGGGGGGGGGGGGGGGAAAAAAAAAAAAAAAAAAAAAAAAA
GGGGGGGGGGGGGGGGGGGGGGGGGDAAAAAAAAAAAAAAAAAAAAAAAA
GGGGGGGGGGGGGGGGGGGGGGGGGGDAAAAAAAAAAAAAAAAAAAAAAA
GGGDGGGGGGGGGGGGGGGGGGGGGGDDAAAAAAAAAAAAAAAAAAAAAA
GDDDDGGGGGGGGGGGGGGGGGGGGGDDADDAAAAAAAAAAAAAAAAAAA
GDDDDGGGDDDDDGGGGGGGGGGGGGGGDDDDAAAAAAAAAAAAAAAAAA
GDDDDDGDDAADDGGGGGGGGGGGGGGGGDDDAAAAAAAAAAAAAAAAAA
GDDDADAAAAAAADGGGGGGGGGGGGGGGGDDAAAAAAAAAAAAAAAAAA
GDDAAAAAAAAAAAGGGGGGGGGGGGGGGGDDAAAAAAAAAAAAAAAAAA
GGAAAAAAAAAAAADGGGGGGGGJGGGGGGGDAAAAAAAAAAAAAAAAAA
GDAAAAAAAAAAADGGGGGJJJJJJJGGGGGDAAAAAAAAAADDAAAAAA
GDAAAAAAAAAAADGGGGGJJJJJJJGGGGGGAADDDDDDDGGDDAAAAA
DDAAAAAAAAAAADGGGJJJJJJJJJJGGGGGDDGGGGGGGGGGDAAAAA
DDAAAAAADAAADGGGJJJJJJJJJJJGGGGGGGGGGGGGGGGGGGGGDA
DDAAAAADDDDGGGGJJJJJJJJJJJJGGGJGGGGJGJJGGGGGGGGGGD
AADDDDAGGGGGGGGJJJJJJJJJJJJGGGJJJGGJJJJJGGGGGGGGGG
AAADGDDGGGGGGGGJJJJJJJJJJJJGJJJJJJJJJJJJJJGGGGGGGG
DDDGGGGGGGGGGGGJJJJJJJJJJJJGGJJJJJJJJJJJJJJGGGGGGG
DGGGGGGGGGGGJJJJJJJJJJJJJJJJJJJJJJJJJJJJJJJJJJGGGG
DDDGGGGGGJJJJJJJJJJJJJJJJJJJJJJJJJJJJJJMJJJJJJGGGG
DDDGGGGGGJJJJJJJJJJJJJJJJJJJJJJJJJJJJMMMJMJJJJJJGG
DDDDGGGJGJJJJJJJJJJJJJJJJJJJJJMMJJJMJMMMMMMJJJJJJG
DDDGGGGGJJJJJJJJJJJJJJJJJJJJMMMMMMMMMMMMMMMJJJJJGG
