GGJJJJJJJJJJJJJJJJJJJJJJMMMJJJJJJJGGGGGGGGGGGGGGGG
GGJJJJJJJJJJJJJJJJJJJJJJJJJJJJJJJJJGGGGGGGGGGGGGGG
GJGGGJJJJJJJJJJJJJJJJJJJJJJJJJJJJGJGGGGGGGGGGGGGGG
JGGGJJJJJJJJJJJJJJJJJJJJJJJJJJJJJGGGGJGGGGGGGGGGGG
JGGGJJJJJJJJJJJJJJJJJJJJJJJJJJJJJJJJJJJGGGGGGGGGGG
JGGGJJJJJJJJJJJJJJJJJJJJJJJJJJJJJJJJJJJGGGGGGGGGGG
GJGGJJJJJGGJJJJJJJJJJJJJJJJJJJJJJJJJJJJGGGGGGGGGGG
GGGJJJJJJGJJJJJJJJJJJJJJJJJMJJJJJJJJJJJGGGGGGGGGGG
GGGGGGGJGGJJJJJJJJJJJJJJJJJJJJJJJJJJJJJGGGGGGGGGGG
JJGGGGGGGGGJJJJJJJJJJJJJJJJJJJJJJJJJJJGGGGGGGGGGGG
GJGGGGGGGGGJJJJJJJJJJJJJJJJJJJJJJJJGGGGGGGGGGGGGGG
JGGGGGGGGGGJJJJJJJJJJJJJJJJJJJJJJJJGGGGGGGGGGGGGGG
GGGGGGGGGGGJJJJJJJJJJJJJJJJJJJJJJJGGGGGGGGGGGGGGGG
GGGGGGGGGGGGGJGGJJJJJJJJJJJJJJJJJGGGGGGGGGGGGGGGGG
GGGGGGGGGGGGGGGGGJJJJJJJJJJJJJJJJGGGGGGGGGGGGGGGGG
GGGGGGGGDGGGGGGGGGJJJJJJJJJJJJJJJGGGGGGGGGGGGGGGGG
GGGGGGDDGGGGGGGGGGGJJJJJJJJJJJJGGGGGGGGGGGGGGGGGGG
GGGGGGDDGGGGGGGGGGGGGJJJJJJJJJGGGGGGGGGGGGGGGGGGGG
GGGGGGDDDGGGGGGGGGGGGGJJJJJJGGGGGGGGGGGGGGGGGGGGGG
GGGGGDDDGGGGGGGGGGGGGGGJJJJGGGGGGGGGDDGGGGGGGGGGGG
DGGGDDDGGGGGGGGDDGGGGGGJJGGGGGGGGGGDDDGGGGGGGGGGGG
DDDDDDDGGGGGGGDDDDDGGGGGGGGGGGGGGDGDDDDDDDGGGGGGGG
GDDDDDDGGDDDDDDDGDGGGGGGGGGGGGGGDAAAAAAAAADDDDGGGG
GDDDDDGGGDDDDDDGGGGGGGGGGGGDDDDDAAAAAAAAAAADDDDGGG
DDDDDDGDDDDDDDGGGGGGGGGGGDDAAAAAAAAAAAAAAAAAADDGGG
DDDDDDDDDDDDDDGGGGGGGGGGDDDAAAAAAAAAAAAAAAAAAAADGG
DDDDDDDDDDDDDDGGGGGGGGGGGDDAAAAAAAAAAAAAAAAAAAADDG
DDDDDDDDGGGDGGGGGGGGGGGGGGDAAAAAAAAAAAAAAAAAAAAADD
DDDDDDDGGGGGGGGGGGGGGGGGGGGGDAAAAAAAAAAAAAAAAAAADD
DDDDDDDDGGGDDGGGGGGGGGGGGGGGGDAAAAAAAAAAAAAAAAAAAA
DDDDGDGGGGGDDGGGGGGGGGGGGGGGGDAAAAAAAAAAAAAAAAAAAA
GGGGGGGGGGGGDGGGGGGGGGGGGGGGGGDAAAAAAAAAAAAAAAAAAA
GGGGGGGGGGGGDGGGGGGGGGGGGGGGGGGDAAAAAAAAAAAAAAAAAA
GGGGGGGGGGGGDGGGGGGJJJJJGGGGGGGDAAAAAAAAAAAAAAAAAA
GGGGGGGGGGGGGGGGGGGGJJJGGGGGGGGDAAAAAAAAAAAAAAAAAA
GGGGGGGGGGGGGGGGGGGGJJJJGGGGGGGGDAAAAAAAAAAAAAAAAA
GGGGGGGGGGJJGJGGGGGGJJJJJGGGGGGGDAAAAAAAAAAAAAAAAA
GGGGGGGGGJJJJJJGJGJJJJJJGGGGGGGGDAAAAAAAAAAAAAAAAA
GGGGGGGJJJJJJJJJJJJJJJJJGGGGGGGGAAAAAAAAAAAAAAAAAA
JJJGGJJJJJJJJJJJJJJJJJJJJJJGGGGDDAAAAAAAAAAAAAAAAA
JJJJJJJJJJJJJJJJJJJJJJJJJGGGGGGAAAAAAAAAAAAAAAAAAA
JJJJJJJJJJJJJJJJJJJJJJJJJGGGGGDAAAAAAAAAAAAAAAAAAA
JJJJJJJJJJJJJMMMJJJJJJJJGGGGGGAAAAAAAAAAAAAAAAAAAA
MJJJJJJJJJJJJMMMMMJJJJJJGGGGDDAAAAAAAAAAAAAAAAAAAA
MMMJJJJJJJJJJMMMMJJJJJJGGGGGDAAAAAAAAAAAAAAAAAAAAA
MMMJMJMJJJJMMMMMMJJJJJJJGGGDADAAAAAAAAAAAAAAAAAAAA
MMMMMMMMJMMMMMMJJJJJJJJJGGGGDDAAAAAAAAAAAAAAAAAAAA
MMMMMMMJMMMMMMMJJMMMJJJJGGGGGGDDDAAAAAAAAAAAAAAAAA
MMMMMMMJMMMMMMMJJMMMMJJJJGGGGGGGDDAAAAAAAAAAAAAAAA
MMMMMMMJJMMMMMMJJMMMJJJJGGGGGGGGGDDDAAAAAAAAAAAAAA
