JJJJJJJJJJJJJJJGGGGGGGGGGGGGGGGDDDDAAAAAAAAAAAAAAA
JJJJJJJJJJJJJJGGGGGGGGGGGGGGGGGDDDAAAAAAAAAAAAAAAA
JJJJJJJJJJJJJJGGGGGGGGGGGGGGGGDDDDAAAAAAAAAAAAAAAA
JJJJJJJJJJJJJJGJGGGGGGGGGGGGDDDDDDDAAAAAAAAAAAAAAA
JJJJJJJJJJJJJJJJJGGGGGGGGGGGGDDGDDDAAAAAAAAAAAAAAA
JJJJJJJJJJJJJJJJGGGGGGGGGGGGGDDDDDDDAAAAAAAAAAAAAA
JJJJJJJJJJJJJJJJJGGGGGGGGGGGGDDDDADDAAAAAAAAAAAAAA
JJJJJJJJJJJJJJJJJJJJGGGGGGGGDDDAAAAAAAAAAAAAAAAAAA
JJJJJJJJJJJJJJJJJJJJJJGGGGGGDGDDAAAAAAAAAAAAAAAAAA
JJJJJJJJJJJJJJJJJJJJJJGGGGGGDDDAAAAAAAAAAAAAAAAAAA
JJJJJJJMJMJJJJJJJJJJJJJGGGGGGGDAAAAAAAAAAAAAAAAAAA
JJJMJJJMMMMJJJJJMMMJJJJJGGGGGGGAAAAAAAAAAAAAAAAAAA
JJJMJMMMMMMMMJMMMMMJJJJJJJGGGGGDAAAAAAADDDAAAAAAAA
JMJMJMMMMMMMMMMMMMMJJJJJJJJGGDDAAAAAAAAAAAAAAAAAAA
JJJMMMMMMMMMMMMMMMJJJJJJJJGGGDAAAAAAAAAAAAAAAAAAAA
JJJMJMMPMMMMMMMMMMJJJJJJJJGGGDAAAAAAAAAAAAAAAAAAAD
MMMMMMMPMMMMMMMJJJJJJJJJJJGGGDAAAAAAAAAAAAAAAAAADD
JMMMMMMMMMMMMJJJJJJJJJJJJJGGGDDDDDDDAAAAAAAAAAADDD
JJMMMJJMMMMJMJJJJJJJJJJJJJGGGGGGGDDDAAAAADAAAAAADG
JJJJMMMMMJJMJJJJJJJJJJJJJJGGGGGGGGGGDAAAAAAAAAAADG
JJJMMMMMMJJMMJJJJJJJJJJJJJGGGGGGGGGGGDAAAAAAAAAADG
JJMPMPPMJJJJJJJJJJJJJJJJJGGGGGGGGGGGGGDAAAAAAAAAAD
JJMMPMMMMJJJJJJJJJJJJJJJJGGGGGGGGGGGGGDDAAAAAAAAAD
JJMMPPMMMJJJJJJJJJJJJJJJJJGGGGGGGGGGGGDDAAAAAAAADD
MMMMPPMMMJJJJJJJJJJJJJJJJJJGGGGGGGGGGGDDAAAAAAAAAD
MMMMPMMMMMJJJJJJJJJJJJJJJJGGGGGGGGGGGGGDAAAAAAAAAD
MMMMPPMMJJJJJJJJJJJJMJJJJJJJJJJGGGGGGGGDAAAAAAAAAA
MMMMMMMMMJJJJJJJJJJJJJJJJJJJJJJJGGGGGGDAAAAAAAAAAA
MMMMMMMMJJJJJJJJJMJJJJMJJJJJJJJJGGGGGGAAAAAAAAAAAD
MMMMMPPMMJJJJJJJJMJJJJMMMJJJJJJJGGGGGGDAAAAAAAAAAA
MMMMMMMMMMJMJJJJMMMJMMMMJJJJJJJGGGGGDDDAAAAAAAAAAA
MMMMPMPPMMMMMMMMMMJJMMMMJJJJJJJGGGGGGGDAAAAAAAAAAA
MMMMMMPMMMMMMJJJJMMMMMJMMJJJJJJGGGGGGGGAAAAAAAAAAA
MMMMMMPMJMMMMMJJMJJJJJJJJJJJJJJJJGGGGGDDAAAAAAAAAA
MMMMMMMMMMMMMMMMMMMJJJJJJJJJJJJJJJGGGGGGAAAAAAAAAA
MMMJJMJMMMMMMMMMMMJMMJJJMMMJJJJJJJJJGGGGGDDDDDAAAA
MMJJJJMMPMJMMMMMJMJMJMJMMMMJJJJJJJJJJJJGGGGGGGGDDD
MMJJJMMMMMMMMMMMJMMMJJMMMMMMMJJJJJJJJJJJGGGGGGGGDD
MMMMJMMMMMMMMMPMMJMMMJJMMMMMMMMMJJJJJJJJJJGGGGGGGG
MMMMMMMMMMMMPPPMMMMMMJMJMMMMMMJJJJJJJJJJJJJGGGGGGG
MMPPPMPPMMPMPPMMMPPMJMMMMMMMMMMJMMMMMJJJJJJJGGGGGG
MMMPPPPPPPPPMPPPPPPMMMMPMMMMMMJJJJMMMJJJJJJJJGGGGG
MMPPPPPPPPPPMPPPPPPPPMMMMMMMMMMMMMJMMMMJJJJJJJJJJG
MPPPPPPPPPPPPPPPPPPPPPPPMMPPMMMJMMMMMMMMJJJJJJJJJG
MMPPPPPPPPPPPPPPPPPPPPPPPMPMMMMMMMMMMMMMJJJJJJJJJG
MPPPPPPPPPPPPPPPPPPPPPPPPPMMMMMMMMMMMMMMJJJJJJJGGG
PPPPPPPPPPPPPPPPPPPPPPPPPPPMMMMMMMMMMMMMMJJJJJJGGG
MPPPPPPPPPPPPPPPPPPPPPPMMPMMMJMMJJMMMMMMMMJJJJJGGG
MPPPPPPPPPPPPPPPMMPMMMPJMMMJJMJJJJJMMJJJJJJJJJJJGG
MPPPPPPPPPMPPPPMMMMPMMMJJMJJJJJJJJJMJJJJJJJJJJJJGG
