DDDGGGGGGGGGGGGGGJJJJJJJJJJGGGGGGGGGJJJJJJJGGGDDDG
DDDGGGGGGGGGGGGGGGJJJJJJJJGGGGGGGGGGGJJJJJGGGGDDDD
DDDGGGGGGGGGGGGGGGJJJJGGJJGGGGGGGGGGGJJGGGGDDDDDDD
DDDDDGGGGGGGGGGGGJJJJGGGGGGGGGGGGGGGGGGGGGGDDDDDDD
DDDDGGGGGGGGGGGGJJJJGGGGGGGGGGGGDGDDGGGGGGDDDDDDDD
DDDDGGGGGGGGGGGGJJJGGGGGGGGGGGDDDDDDDDDDDDDDDDDDDD
DDDDDGGGGGGGGGGGGGGGGGGGGGGGGDDDDDDDDDDDDDDDDDDDDD
DDDDDDGGGDDGGGGGGGGGGGGGGGGDDDDDDDDDDDDDDDDDDDDDDD
DDDDDDDDDDDDGGGGGGGGGGGGGGGDDDDDDDDDDDDDDDDDDDDDDD
DDDDDDDDDDDDDGGGGGGGGGGGGDDDDDDDDDDDDDDDDDDDDDDDDD
DDDDDDDDDDDDDDGGGGDDGGGDDDDDDDDDDDDDDDDDDDDDDDDDDD
DDDDDDDDDDDDDDDDGDDDDGDDDDDDDDDDDDDDDDDDDDDDDDDDDD
DDDDDDDDDDDDDDDDGGDDDDDDDDDDDDDDDDDDDDDDDDDDDDDDDD
GDDDDDDDDDDDDDDDDDDDDDDDDDDDDDDDDDDDDDDDDDDDDDDDDD
GGGDDDDDDDDDDDDDDDDDDDDDDDDDDDDDDDDDDDDDDDDDDDDDDD
GGGGDDDDDDDDDDDDDDDDDDDDDDDDDDDDDDDDDDDDDDDDDDDDDD
JGGGGGGGDDDDDDDDDDDDDDDDDDDDDDDDDDDDDDDDDDDDDDDDDD
JGGGGGGGGGDDDDDDDDDDDDDDDDDDDDDDDDDDDDDDDDDDDDDDDD
JGGGGGGGGDDDDDDDDDDDDDDDDDDDDDDDDDDDDDDDDDDDDDDDDD
JGGGGGGGGGDDDDDDDDDDDGGDDDDDDDDDDDDDDDDDDDDDDDDDDD
GGGGGGGGGGDDDDDDDDDDDDDDDDDDDDDDDDDDDDDDDDDDDDDDDD
GGGGGGGGGGGDDDDDDDDDDDGDDDDDDDDDDDDDDDDDDDDDDDDDDD
GGGGGGJGGGGGDDDDDDDDDGDDDDDDDDDDDDDDDDDDGGGGDDDDDD
JGGGGGJGGGGDDDDDDGGGGGDDDDDDDDDDDDDDDDDGGGGGGGDDDD
JGJGGGGGGGGGDDDDDGGGGDDDDDDDDDDDDDDDDGDGGGGGGGGDDD
JJJGGGGGGGGGDDDDDGGGGDDDDDDDDDDDDDDDDGGGGGGGGGGGDD
JJJJJGGGGGGGDDDDGGGGGGDDDDDDDDDDDDDDDGGGGGGGGGGGGD
JJJJJGGGGGGGDDDDGGGGGGGDDDDDDDDDDDDDDGGGGGGGGGGGGG
JJJJJJGGGGGGGDGGGGGGGGGDDDDDDDDDDDDDDGGGGGGGGGGGGD
JJJJJJJJGJGGGGGGGGGGGGGGDDDDDDDDDDDDDGGGGGGGGGGGGD
JJJJJJJJJJJGGGGGGGGGGGGGDDDDDDDDDDDDDGGGGGGGGGGGDD
JJJJJJJJJJJJGGGGGGGGGGGGGDDDDDDDDDDDGGGGGGGGGGGGDD
JJJJJJJJJJJJGGGGJGGGGGGGGDDDDDDDDDDGGGGGGJGGGGGDDD
MJJJJJJJJJJJJJJJJJGJGGGGGDDDDDDDDDDGGGGGGGGGGGGGDD
MJJJJJJJJJJJJJJJJJGJJJGGGDDDDDDDDDGGGGGGGGGGGGGGGG
JJJJJMMJJJJJJJJJJJJJJJGGGDDDDDDDDDGGGGGGJJJJJJJGGG
JJJJMMMMJJJJJJJJJJJJJGGGGDDDDDDDDDGGGGJJJJJJJJJJJG
JJJJJMMMJJJJJJJJJJJJJJGGGGDDDDDDDGGGGGJJJJJJJJJJJJ
JJJJJMMMMMJJJJJJJJJJJJGGGGGDDDDDDGGGGGJJJJJJJJJJJG
JJJJJMMMMMJJJJJJJJJJJJGGGGGGGDDDGGGGGGJJJJJJJJJJJJ
JJJJJJMMMMJJJJJJJJJJJJGGGGGGGGGGGGGGGJJJJJJJJJJJJJ
JJJJJJJMMMJJJJJJJJJJJJGGGGGGGGGGGGGGJJJJJJJJJJJJJJ
JJJJJJJJMMJJJJJJJJJGGGGGGGGGGGGGGGGGGJJJJJJJJJJJJJ
JJJJJJJJMMJJJJJJJJJGGGGGGGGGGGGGGGGGJJJJJJJJJJJJJJ
JJJJJJJJJJJJJJJJJGGGGGGGGGGGGGGGGGGGJJJJJJJJJJMJJJ
JJJJJJJJJJJJJJJJGGGGGGGGGGGGGGGGGGGJJJJJJJJJJMMJJJ
JJJJJJJJJJJJJJJJGGGGGGGGGGGGGGGGGGGJJJJJJJJMMMMJJJ
JJJJJJJJJJJJJGGGGGGGGGGGGGGGGGGGGGJJJJJJJMMMMMMJJJ
JJJJJJJJJJJJJJGGGGGGGGGGGGGGGGGGJJJJJJJJMMMMMMJJJJ
JJJJJJJJJJJJJGGGGGGGGGGGGGGGGGGGGGGJJJJJMMMMMMMJJJ
