GGGGGGGAAAAAAAAAAAAAAAAAAAAAAAAAAAAAAAAAAAAAAAADDD
GGGGGGGGAAAAAAAAAAAAAAAAAAAAAAAAAAAAAAAAAAAAAAADGG
GGGGGGGGGAAAAAAAAAAAAAAAAAAAAAAAAAAAAAAAAAAAAADGGG
GGGGGGGGGDAAAAAAAAAAAAAAAAAAAAAAAAAAAAAAAAAAAADGGG
GGGGGGGGGDDAAAAAAAAAAAAAAAAAAAAAAAAAAAAAAAAAAADGGG
GGGGGGGGGDDAAAAAAAAAAAAAAAAAAAAAAAAAAAAAAAAAAADGGG
JGGGGGGGGGDAAAAAAAAAAAAAAAAAAAAAAAAAAAAAAAAAADGGGG
JJJJGGGGGDDAAAAAAAAAAAAAAAAAAAAAAAAAAAAAAAADGDGGGG
JJJJGGGGDDDAAAAAAAAAAAAAAAAAAAAAAAADDDAADDGGGGGGGG
JJJJGGGGGDAAAAAAAAAAAAAAAAAAAAAAAAGGGGDDGGGGGGGGGJ
JJJJJGGGGDAAAAAAAAAAAAAAAAAAAAADDGGGGGGGGGGGGGGJJJ
JJJJJGGGGDDAAAAAAAAAAAAAAAAAAADDGGGGGGGGGGGGGGGGJJ
JJJJJGGGGGDAAAAAAAAAAAAAAAAAAADDGGGGGGGGGGGGGGGGGJ
JJJGGGGGGGDAAAAAAAAAAAAAAAAAAAADGGGGGGGGGGGGGGGGGJ
JJJGGGGGGGDDAAAAAAAAAAAAAAAAADDGGGGJGGGGGGGGGGGGGG
JJGGGGGGGGDDAAAAAAAAAAAAAAADDGGGGGJJJJJJGGGGGGGGGG
JJGGGGGGDGGDAAAAAAAAAAAAAAAGGGGGJJJJJJJJGGGGGGGGGG
JGGGGGGDDDDDAAAAAAAAAAAAAADGGGGJJJJJJJJJGJGGGGGGGG
JGGGGGGDDDDDAAAAAAAAAAAAADDGGGGJJJJJJJJJJJJJGJJJJJ
JJGGGGGDDDDDAAAAAAAAAAAADGDGGGJJJJJJJJJJJJJJJJJJJJ
JJJGGGGGDDDDAAAAAAAAAADDGGGGGGJJJJJJJJJJJJJJJJJJJJ
JJJGGGGGDDDAAAAAAAAAAADGGGGGJJJJJJJJJJJJJJJJJJJJJJ
JJJGGGGGGDDAAAAAAAAADDGGGGGGGJJJJJJJJJJJJJJJJJJJJJ
JJJJGGGGGDDAAAAAAAAADDGGGGGGJJJJJJJJJJJJJJJJJJJJJJ
JJJJJGGGGDDDAAAAAAAADGGGGGGGJJJJJJJJJJJJJJJJJJJJJJ
JJJJJGGGGGGDDAAAAAADDGGGGJJJJJJJJJJJJJJJJJJJJJJJJJ
JJJJJGGGGGGGDAAAAADDGGGGGGJJJJJJJJJJJJJJJJJJJJGJJJ
JJJJJJGGGGGGGDDDDDGDDGGGGGJJJJJJJJMJJJJJJJMJJJJJJJ
JJJJJJJGGGGGGGGGGGGDGGGGGGJJJJJJJJMMMMMJJJJJJJJJJJ
JJJJJJJGGGGGGGGGGGGGGGGGGGJJJJJMMMMMMMMJJJJMJJJJJJ
JGGJJJJGGGGGGGGGGGGGGGGGGGJJJJJMMMMMMMMMJJJMJJJJJJ
GGGJJJJJGGGJGGGGGGGGGGGGGJJJJJJJMMMMMJMMJJMMMMMMJJ
GGGJJJJJGGGGGGGGGGGGGGGGJJJJJJJMMMMMMMMJJJJJJMMJJJ
GGJJJJJGGGGGGGGGGGGGGGGJJJJJJJMMMMMMMMMJJJJJMMMMJJ
GGJJJJJGGGGGGGGGGGGGGGJJJJJJJJMMMMMMMMJJJMJMMMPMMJ
GGGJJJJJJJJGGGGGGGGGGJJJJJMJMMMMMMMMMJJJJJJMMMPMMJ
GGGGJJJJJJGGGGGGGGJJJJJJJJMMMMMMMMMMMJJJJJJMMMMMMM
GGGJJJJJJGGGGGGGGJJJJJJJJJMMMMMMMJMMMMMJJJJJMMMMJJ
GGGJGGGGGGGGGGGGGJJJJJJJJJJMMMMMMMJJJMMMMJMMMMMMPM
GGGGGGGGGGGGGGGGGGJJJJJJJJJMMMMMMMMJJMMMMMMMPPPPPM
GGGGGGGGGGGGGGGGGGGJJJJJJJJJMMMMMMJJJJMMMMMMMPPPMM
GGGGGGGGGGGGGGGJJJJJJJJJJJJJMJMJJMJJJJJMMMMMPPPPPP
GGGGGGGGGGGGGGGJJJJJJJJJJJJJJJJJJJJJJJMJMMPPPPPPPP
GGGGGGGGGGGGGGGJJJJJJJJJJJJJJJJJJJJJJJJMMMPPPPPPPP
GGGGGGGGGGGGGJJJJJJJJJJJJJJJJJJJJJJMJJJJMMMPPPPPPP
GGGGGGGGGGGGGJJJJJJJJJJJJJJJJJJJJJMJJJJJJMMMMMMPMM
GGGJJJJGGGGGGJJJJJJJJJJJJJJJJJJJJJJJJJJJJJMMMMMMMM
GJJJJJJJJGGGGJJJJJJJJJJJJJJJJJJGJJJJJJMJJJJMMMMMMJ
GJJJJJJJJJGGGJJJJJJJJJJJJJJJJJGGJJJJJJJJJJJMMJMMJM
JJJJJJJJJJGGJJJJJJJJJJJJJJJJJJGGJJJJJJJJJJJJJMMMMJ
