PPPPPPPPPPPPPPPPPMMMMMMMMJJJJGJGGGGGGDDDDGDDDDDGGG
PMMMPPPPPPPPPPPPPPMMMJJJJJJJJGJGGGGGGADDDDDDDDGGGG
MMJJMMMPPMPPPPPPPPMMMMJJJJJJGGGGGGGGGDDAADDDDDGGGG
MMJMMMMPMMMMPPPPPPMMJJJJJGGGGGGGGGGGDAAAAAADADGGGG
MJMMMMMPMMMPPPPMMMMMJJJJJGGGJGGGGGGGDAAAAAAAADGGGG
JMMMMMMPMMMPPPMMMMJJJJJJJJGJJGGGGGGGAAAAAAAAAADGGG
MMMMMMJMJMPMMMMMMJJJMJJJJJGJJGGGGGGGAAAAAAAAADGGGG
MMMPMMJJMMMMMMMMMMMMMJJJJGJJJGGGGGDDAAAAAAAAADDGGG
MMMMMMJJMMMMMMMMMMMJJJJJJJGGGGGGGDDDAAAAAAAAAAADGG
MMMJJJJJJMMMJMMMMMMMJJJJJJJJGGGGGDAAAAAAAAAAAAADGG
MJMJJJJJJMJJJJMMMMMMJJJJJJJJGGGDDDAAAAAAAAAAAAADGG
MMMMJJJJJMMMJJMMMMMMJJJJJJJGGGGDAAAAAAAAAAAAAADGGG
MMMJJJJJJJJJJJMMMJJJJJJJJJGGGGDAAAAAAAAAAAAAAAGGGG
MMJJJJJJJJJJJJMMMJJJJJJJJJGGGGAAAAAAAAAAAAAAAADGGG
JJJJJJJJJJJJJJJJJJJJJJGGGGGGGGAAAAAAAAAAAAAAAADGGG
JJJJJJJJJJJJJJJJJJJJJJGGGGGGGGDAAAAAAAAAAAAAAAADGG
JJJJJJJJJJJJJJJJJJJJJGGGGGGGGDAAAAAAAAAAAAAAAAAADG
JJJJJJJJJJJJJJJJJJJJJJGGGGDDDAAAAAAAAAAAAAAAAAAAAD
JJJJJJGJJJJJJJJJJJJJJJGGGGDAAAAAAAAAAAAAAAAAAAAAAD
JJJJJGJJJJJJJJJJJJJJJJGGGDAAAAAAAAAAAAAAAAAAAAAAAD
JJJJJJGGJJJJJJJJJJJJJJGGGDAAAAAAAAAAAAAAAAAAAAAAAA
JJJJJGGGGGJJGJGJJJJJJJGGGDAAAAAAAAAAAAAAAAAAAAAAAA
JJJJGGGGJGJJGGJJJJJJJJGGGDAAAAAAAAAAAAAAAAAAAAAAAA
JJJJGGJGGGJGGGJJJJJJJJGGGGDAAAAAAAAAAAAAAAAAAAAAAA
JJJGJJJJGGJGGGJJJJJJJJGGGGDAAAAAAAAAAAAAAAAAAAAAAA
JJJJJJJJJGGGGGGGJJJJJJGGGGDAAAAAAAAAAAAAAAAAAAAAAA
JJJJJJGJJJJJGGGJJJJJJGGGGGDDDAAAAAAAAAAAAAAAAAAAAA
JJJJJGGJJJJJGJGJJJJJGGGGGDDDDDDDDDDDAAAAAAAAAAAAAA
JJGGGJJJJJJGGJJGGGGGGGGGDDADGDDGGDDDDAAAAAAAAAAAAA
GGGGGGGJJJJGGGGGGGGGGGGGDAADDDDGDDDDDAAAAAAAAAAAAA
GGGGGGGGGGGGGGGGGGGGGGGDAAAADDDDDDDDAAAAAAAAAAAAAA
GGGGGGGGGGGGGGGGGGGGGGGDAAAAAAAAADAAAAAAAAAAAAAAAA
GGGGGGGGGGGGGGGGDGDGGDDAAAAAAAAAAAAAAAAAAAAAAAAAAA
GGGGGGGGDDGGGGGGDGGDAAAAAAAAAAAAAAAAAAAAAAAAAAAAAA
GGGDDDGDDDDDDDDDDDDAAAAAAAAAAAAAAAAAAAAAAAAAADDDDD
GGDDDAAAAAAAAAADAAAAAAAAAAAAAAAAAAAAAAAAAAAADDGGGG
GDDAAAAAADDAAAAAAAAAAAAAAAAAAAAAAAAAAADDDDDDADGGGD
DDAAAAAADDDAAAAAAAAAAAAAAAAAAAAAAADADDGGGGGGDDGGGG
DAAAAADDAAAAAAAAAAAAAAAAAAAAAAAAADGGGGGGGGGGGGGGGG
DDDAADDDDDAAAAAAAAAAAAAAAAAAAAAADGGGGGGGGGGGGGGGGG
GGDDDDDDDDAAAAAADDAAAAAAAAAAAADGGGGGGGJJJGGGGGGGGG
GGGDDDDDDDDDDDGGGDDAAAAAAAAAAADGGGGGGJJJJGGGGGGGGG
GGGGGGGGGGGGGGGGGGDDAAAAAAAAAADGGGGGJJJJJGGJGGGGGG
GGGGGGGGGGGGGGGGGGGDDDDDAAAAAADGGGGGJJJJJJJJJJJJGG
GGGGGGGGGGGGGGJGGGGGGGGGGGDDGGGGGGGGJJJJJJJJJJJJJG
GGGGGGGGGGGGGJJJJGGGGGGGGGGGGGGGGGGGGJJJJJJJJJJJJJ
GGGGGGGGGGGGJJJJJJGGGGGGGGGGGGGGGGGGJJJJJJJJJJJJJJ
GGGGGGGGGGGJJJJJJJJJJJJGGGGGGGJJGGGGGGJJJJJJJJJJJJ
GGGGGGGGGGJJJJJJJJJJJJJJJJJJJJJJGGGGGGGJJJJJMMJJJJ
GGGGGGGGJJJJJJJJJJJJJJJJJJJJJJJGGGGGGGGJJJJJJJJJJJ
