AAAAAAAAAAAAAADGGGGGGGGJJJJJJJJJJJJJJMMMMMPPMPMMMP
AAAAAAAAAAAAAADDGGGGGGGGJJJGJJJJJJJJJJJMMMPPMMMPMP
AAAAAAAAAAAAAAAAGDGGGGGGGGGGGJJJJJGGJJJMMMMPPPPPMP
AAAAAAAAAAAAAAAADGGGGGGGGGGDGGGGGGGGJJJJMMMMMMPMMM
AAAAAAAAAAAAAAAAADGDGGGGDGDDDGGGGGGGJJJJMMMJMJMMMM
AAAAAAAAAAAAAAAAAADDGGDAADDDDGGGGGGGJJJJMMJJJMMMJM
AAAAAAAAAAAAAAAAAAAADAAAAADDDGGGGGGGJJJJJJJJMMJMMM
AAAAAAAAAAAAAAAAAAAAAAAAAADDGDDGGGGGJJJJJJMMMMMMPP
AAAAAAAAAAAAAAAAAAAAAAAAAGGGGDDGGGGGGGJJJMJMMPMPPP
AAAAAAAAAAAAAAAAAAAAAAAAAGGGGGGGGGGGGGJJJMMMMMPPPP
AAAAAAAAAAAAAAAAAAAAAAAAAGGGGGGGGGGGGGJJMMMMMPPPPP
AAAAAAAAAAAAAAAAAAAAAAAAADDGGGGGGGGGGJJMMMMMPPPPPP
AAAAAAAAAAAAAAAAAAAAAADDADDGGGGGGGGGJJJMMPPPPMPPPP
AAAAAAAAAAAAAAAAAAAAADDDDGGGGGGGGGGGJJJJMPPPMMMPPP
AAAAAAAAAAAAAAAAAAAADDGGGGGGGGGGGGGGGJJJJMMPMMPMMP
AAAAAAAAADDDDDDAAADDGGGGGGGGGGGGGGGGGJJJMMMMMJMMMM
AAAAAAAADGGGGDDDAAGGGGGGGGGGGGGGGGGGGJJJJMMJMJMMMM
AAAAAAADGGGGGGGGGGGGGGGGGGGGGGGGGGGGJGJJJJJMJJMMMM
AAAAAADDGGGGGGGGGGGGGGGGGGGGGGGGGGGJJJJJJJJMMMMJJM
GDGGGGGGGGGGGGGGGGGGGGGGGGGGGGGGGGJJJJJJJJJJMMMMMM
GGGGGGGGGGGGGGGGGGGGGGGGGGGGGGGGGGGGGJJJJJJJMMMPMM
GGGGGGJJJJJJGGGGGGGGGGGGGGGGGGGGGGGGGGGJJJJJMMMMPP
JJJGJJJJJJJJGGGGGGGGGGGGGGGGGGGGGGGGGGGJJJJJJJMPPP
JJJJJJJJJJJJJGGGGGGGGGGGGGGGGGGGGGGGGGGGJJJJJMMMPP
JJJJJJJJJJJJJGGGGGGGGGGGGGGGGGGGGGGGGGGGJJJJJJJMMM
JJJJJJJJJJJJJGGGGGGGGGGGGGGGGGGGGGGGGGGGGJJJJJJJJM
JJJJJJJJJJJJGGGGGGGGGGGGGGGGGGGGGGGGGGGGJJJJJJJJJJ
JJJJJJJJJJJJGGGGGGGGGGGGGGGGGGGGGGGGGGGGJJJJJJJJJJ
JJJJJJJJJJJGGGGGGGGGGGGGGGGGGGGGGGGGGGJJJJJJJJJJJJ
JJJJJJJJJJGGGGGGGGGGGGGGGGGGGGGGGGGGGGJJJJJJJJJJJJ
JJJJJJJJJJJGGGGGGGGGGGGGGGGGGGGGGGGGJJJJJJJJJJJJJJ
JJJJJJJJJJJJGGGGGGGGGGGGGGGGGGGGGGGGGJJJJJJJJJJJJJ
JJJJJJJJJJJJGGGGGGGGGGGGGGGGGGGGGGGGGJJJJJJJJJJJJJ
JJJJJJJJJJJJGGGGGGGGGGGGGGGGGGGGGGGGGGGJJJJJJJJJJJ
JJJJJJJJJJJJGGGGGGGGGGGGGGGGGGGGGGGGGGGGJJJJJJJJJJ
JJJJJJJJJJJJJGGGGGGGGGGGGGGGGGGGGGGGGGGGJJJJJJJJJJ
JJJJJJJJJJJJJJGGGGGGGGGGGGGGGGGGGGGGGGGGGJJJJJJJJJ
JJJJJJJJJJJJJJGJGGGGGGGGGGGGGGGGGGGGGGGGGJJJJJJJJJ
JJJJJJJJJJJJJJJJJGGGGGGGGGGGGGGGGGGGGGGGGJJJJJJJJJ
MJJJJJJJJJJJJJJGGGGGGGGGGGGGGGGGGGGGGGGGGGJJJJJJJJ
MMMJJJJJJJJJJJJGGGGGGGGGGGGGGGGGGGGGGGGGGGJJJJJJJJ
MMJJJJMJJJJJJJJJJJJGGGGGGGGGGGGGGGGGGGGGGGJJJJJJJJ
MMMMJMMMJJJJJJJJJJJJGGGGGGGGGGGGGGGGGGGGGGJJJJJJJJ
MMMMMMMMJJJMJJJJJJJJJGGGGGGGGGGGGGGGGGGGGGJJJJJJJJ
MMMJMJMMMMMMJJJJJJJJJGGGGGGGGGGGGGGGGGGGGGGJJJJJJJ
MMMMMMMMMMMMMJJJJJJJJGGGGGGJGGGGGGGGGGGGGGGJJJJJJJ
PMMPPPPMMMMMMMMJJJJJGGGGGGGJGGGGGGGGGGGGGGGJJJJJJJ
PPPPPPMPMMMMMMMJJJJGGGGGGGGJGGGGGGGGGGGGGGGJJJJJJJ
PPPPPPMPPMMMMMJJJJJGGGGGGGGJJJGGGGGGGGGGGJJJJJJJJJ
PPPPPMMPPMMMMMJJJJJGGGGGGJJJJJJGGGGGGGGGJJJJJJJJJJ
