MJJJJJJJJJJJJJJMMMPPPPPPMJJMPPPPPMMPMMJJMMMMMMMMMM
MJJJJJJJJJJJMMMMMPPPPPMMMJMMMPMMPMJMPMMMMJMMMMMMMJ
JJJJJJJJJJJJMMMPPPPPPPPMMMMJJJPMJMMMPPMJJMJMJMMMMM
JJJJJJJJJJJJJJJMMMPPPPPPPMMPPJMMMJPPMMMMMPMPMMMMMJ
JJJJJJJJJJJJJJMMPMMMPPMPPMMMMMJMMMMPMJJMMMPMMMJJMM
JJJJJJJJJJJJJMMMMMMMPMMMMMJMMJJJJMMPPMPPPMMJMMMMMP
JJJJJJJJJMJJJMMMMMMMMMMMMMJJMMJJJMJMJMMPPPMJMMMPMP
JJJJJJJJJMJMMMMMMJMMMMMJMMMJMJMJJMMJJMPPPPMMMMPPPP
JJJJJJJJJJMMMMMMMMMMMJJJJJJJJJJJMMMMJJMPPPPPPPPPPP
JJJJJJJJJJMMMMMMMJMMJJJJJJJJJJJJMPMMMJMPPPMPPMPPPP
JJJJJJJJJJJMJJJJMMJJJJJJJJJJJJJMMPMMJMMPPPMPPPMMMM
JJJJJJJJJJJJJJJJJMMJJJJJJJJJJJJMMMMMMMMMPPPPPPPMMP
JJJJJJJJJJJJJJJJMMMJJJJJJJJJJJJMMMMMMMPPPPPMPMMPPP
JJJJJJJJJJJJJJJJMMMJJJJJJJJJJJMMMMMMMMMMMMPPPPMPMP
JJJJJJJJJJJJJJJJMMMJJJJJJJJJJJJJMMMPPMPMMPMPMMMPMM
JJJJJJJJJJJJJJJJJJJJJJJJJJJJJJJJJMMMMMPMPPPMMJMMMM
JJJJJJJJJJJJJJJJJJJJJJJJJJGGGGJJJMMMMPMMPPPMMJMMMM
JJJJJJJJJJJJJJJJJJJJJJJJJGGGGGGJJJJJMPMMPPPMMJPMPP
JJJJJJJJJJJJJJJJJJJJJJJJGGGGGGGGJJJJMMMMMMMPMMMMPP
JJJJJJJJJGGJJJJJJJGJJGGGGGGGGGGGGGJJJJJJJMMMJMJMPP
JJJJJJJGGGGGGGJJGGGGGGGGGGGGGGGGGGGJJJJJJMMJMPJMMP
JJJJJJJGGGGGGGGGGGGGGGGGGGGGGGGGGGGJJJJJJJMJJMPPMP
GGGGGGGGGGGGGGGGGGGGGGGGGGGGGGGGGGGJJJJMJJMJJMMMPM
GGGGGGGGGGGGGGGGGGGGGGGGGGGGGGGGGGGJJJJMJMMJJMMMPM
GGGGGGGGDDGGGGGDDDDDGGGGGGGGGGGGGGGJJJJMMJJMMJJJMJ
GGGGGGGDDDDDDDAAAAAADDGGGGGGGGGGGGJJJJJJMJJJJJMMMM
DDDGGGDDDDDAAAAAAAAAAADGGGGGGGGGGJJJJJMMJJMJJJMMMM
DDDGGGDDDDAAAAAAAAAAADDDGGGGGGGGGJJJJJMMMMMMMJJMMM
DDDDDGGDDDAAAAAAAAAAADDGGGGGGGGGGJJJJJJMMMMMJMMMMM
DDDDDGDDDDAAAAAAAAAAAADDDDGGGGGGGJJJJJJMMMMMMMMMMM
DDDDDDDDDAAAAAAAAAAAAAAADADGGGGGGJJJJJJMMJJJJMMMMM
DDDDDGGDDAAAAAAAAAAAAAAAAADGGGGGGGJJJJJJJJJJJMMJMJ
DDDDDGGDDAAAAAAAAAAAAAAAADDGGGGGGJJJJJJJJJJJJMJJJJ
DDDDDDDDAAAAAAAAAAAAAAAAAAAGGGGGGJJJJJJJJJJJJMJJMM
GGGDDAAAAAAAAAAAAAAAAAAAADDDGGGGGJJJJJJJJJJJJJJJMM
GDGDAAAAAAAAAAAAAAAAAAAAADDDGGGGGJJJJJJJJJJJJJJMMM
DAAAAAAAAAAAAAAAAAAAAAAAAADGGGGGJJJJJJJJJJJMJJJJJJ
AAAAAAAAAAAAAAAAAAAAAAAAAADGGGGGGJJJJJJJJJJMJJJJJJ
AAAAAAAAAAAAAAAAAAAAAAAAADDGGGGGGGJJJJJJJJJJJJJJJJ
AAAAAAAAAAAAAAAAAAAAAAAAAADGGGJJGGGJJJJJJJJJJJJJJJ
AAAAAAAAAAAAAAAAAAAAAAAAAADGGGJJGGGJJJJJJJJJJJJJJG
AAAAAAAAAAAAAAAAAAAAAAAAAADGGGGGGGGJJJJJJJJJJJJJGG
AAAAAAAAAAAAAAAAAAAAAAAAAADDGGGGGGGJJJJJJJJJJJJJJG
AAAAAAAAAAAAAAAAAAAAAAAAAAADDGGGGGGGJJJJJJJJJJJJJG
AAAAAAAAAAAAAAAAAAAAAAAAAAAADDDGGGGGGGGJJJJJJJJJJG
DDAAAAAAAAAAAAAAAAAAAAAAAAAAADDDGGGGGGGJJJJJJJJJJG
DDAAAAAAAAAAAAAAAAAAAAAAAAAAAAADGGGGGGGJJJJJJJJJJG
GAAAAAAAAAAAAAAAAAAAAAAAAAAAAAADDDDGGGGGJJJJJJJJJJ
GDAAAAAAADAAAAAAAAAAAAAAAAAAAAAADDDDDGGGJJJJJJJJJJ
GGDDGDDDDDADAAAAAAAAAAAAAAAAAAAAAADDDGGGGJJJJJJJJJ
