GGGGJJJJJJJJJJJJJJJJJJJJJJJJJJJJJJJJJJJJJJJJJJJJJJ
GGGGGJJJJJJJJJJJJJJJJJJJJJJJJJJJJJJJJJJJJJJJJJJJJJ
GGGGGGGJJJJJJJJJJJJJJJJJJJJJJJJJJJJJJJJJJJJJJJJJJJ
GGGGGGGGJJJGJJJJJJJJJJJJJJJJJJJJJJJJJJJJJJJJJJJJJJ
GGGGGGGGGGGGGGJJJJJJJJJJJJJJJJJJJJJJJJJJJJJJJJJJJJ
GGGGGGGGGGGGGJJJGGGGJJJJJGJGJGJJJJJJJJJJJJJJJJJJJJ
GGGGGGGGGGGGGJJJGGGGJJJJGGGGGGGGGJJJJJJJJJJJJJJJJJ
GGGGGGGGGGGGGJJJGGGGGGGGGGGGGGGGGGJJJJJJJJJJJJJJJJ
GGGGGGGGGGGGGGGGGGGGGGGGGGGGGGGGGGJJJJJJJJJJJJJJJJ
GGGGGGGGGGGGGGGGGGGGGGGGGGGGGGGGGGGJJJJJJJJJJJJJJJ
GGGDDGDDDDDDGGGGGGGGGGGGGGGGGGGGGGGJJJJJJJJJJJJJJJ
GGGDDDDDDDDDDDDDDDADGGGGGGGGGGGGGGJJJJJJJJJJJJJJJG
DDDDDDDDDDDDAAAAAAADGGGGGGGGGGGGGGJJJJJJJJJJJJJJJG
GDDDDAAAAAAAAAAAAAAAADGGGGGGGGGJGGJJJJJJJJJJJJJJGG
DDAAAAAAAAAAAAAAAAAAADGGGGGGGGJGJGGJJJJJJJGJJJJGGG
DAAAAAAAAAAAAAAAAAAAADGGGGGGGJJGJGGJJJJJJJJGGGGGGA
GDDAAAAAAAAAAAAAADAAADGGGGGGGGGGGGGGJJJJJJGGGGGGDA
GGGDAAAAAAAAAAAAADDDADGGGGGGGGGGGGGGGJJJGGGGGGGDAA
GGGGAAAAAAAAAAAAADDDDDDGGGGGGGGGGGGGGJGGGGDDADDAAA
GGGGDAAAAAAAAAAAAADDDDGGGGGGGGGGGGGGGGGGGGDDAAAAAA
GGGGDAAAAAAAAAAAAADDADGGGGGGGGGGGGGGGGGGGGDDAAAAAA
GGGGDDAAAAAAAAAAADDDDDGGGGGGGGGGGGGGGGGGGDDDAAAAAA
JGGGGDDAAAAAAAAAAAAADDGGGGGGDGGGGGGGGGGGDDDAAAAAAA
JGGGGGGDAAAAAAAAAADDDDGGGGGGDDDGDGGGGGGGDDDAAAAAAA
JJJGGGGGGDDAAAAADDDGDDDDDDDAAAADDGGGDDGDDDDAAAAAAA
JJJJJJGGGGDAAAADDGGGGDDAAAAAAAAADDGGDDDDDDAAAAAAAA
JJJJJJJGGGGDAAADDDDGGDAAAAAAAAAADDDDDDDDDDAAAAAAAA
JJJJJJJGGGGDDAAAAADDDDAAAAAAAAAADDDDDDDAAAAAAAAAAA
JJJJJJJGGGGGDDDAAAAAAAAAAAAAAAAAAAAAAAAAAAAAAAAAAA
JJJJJJJJGGGGDDDAAAAAAAAAAAAAAAAAADAAAAAAAAAAAAAAAA
JJJJJJJGGGGGDDDDAAAAAAAAAAAAAAAAAAAAAAAAAAAAAAAAAA
JJJJJJGGGGGDDDAAAAAAAAAAAAAAAAAAAAAAAAAAAAAAAAAAAA
JMJJJJGGGGGGGDDAAAAAAAAAAAAAAAAAAAAAAAAAAAAAAAAAAA
MMJJJJJJGGGGGGDAAAAAAAAAAAAAAAAAAAAAAAAAAAAAAAAAAA
MMMJJJJJGGGGGGGAAAAAAAAAAAAAAAADDDAAAAAAAAAAAAAAAA
MMJJJJJJGGGGGGGDAAAAAAAAAAAAAAAADDAAAAAAAAAAAAAAAA
MMJJJJJJGGGGGGGGDDDAAAAAAAAAAAAAADAAAAAAAAAAAAAAAA
MMMJJJJJJGGGGGGGGGGDAAAAAAAAAAAAAAADAAAAAAAAAAAAAA
MMMJJJJJJJGGGGGGGGGGDDAAAAAAAAAAAAAAAAAAAAAAAAAAAA
MMMJJJJJJJJGGGGGGGGGGDAAAAAAAAAAAAAAAAAAAAAAAAAAAA
MMMMMJJJJJJGJJJGJGGGGDDAAAAAAAAAAAAAAAAAAAAAAAAAAA
PPMMMJJJJJJJJJJJJJGGGDAAAAAAAAAAAAAAAAAAAAAAAAAADG
PPPMMMMMMJJJJJJJJJGGGAAAAAAAAAAAAAAAAAAAAAAAAAAGGG
PPPMMMMMMMMJJJJJJJJGGDAAAAAAAAAAAAAAAAAAAAADDDDGGG
PPPMMMMMMJMJJJJJJJJGGGDAAAAAAAAAAAAAAAAAAADDDDGGGG
PPPPMMMJMMJJJJJJJJJGGGDAAAAAAAAADAAAAAAAAADGGGGGGG
PPPPPMMMMMMJJJJJJJJJGGGDGDDADDDGGGDDAAAAAGGGGGGGGG
PPMMMMMMMMMMMJJJJJJJJGGGGGGGGGGGGGGGGGDADGGGGGGGGG
MMMMMPMMMMMMMJJMJJJJJGGGGGGGGGGGGGGGGGGDDGGGGGGGGG
MMPPPPMMMMMMMJJJJJJJJJGGGGGGGGGGGGGGGGGDDGGGGGGGGG
