AAAAAAAAAAAAAAAADGGGGJJJJJJJJJJJJJJJJJJJMMMMMMMMMJ
AAAAAAAAAAAAAAAADDGGGGJJJJJJJJJJJJJJJJJJMMJMMMMMMM
AAAAAAAAAAAAAAAAADGGGGGJJJJJJJJJJJJJJJJJJJJJMMMMMM
AAAAAAAAAAAAAAAADADGGGGGJJJJJJJJJJJJJJJJJJJMMMMJJM
AAAAAAAAAAAAAAAAAADGGGGGGJJJJJJJJJJJJJJJJJJMMMMJJJ
AAAAAAAAAAAAAAAAADGGGGGGGGJJJJJJJJJJJJJJJJJMMMMJJJ
AAAAAAAAAAAAAAAAADGGGGGGGGJJJJJJJJJJJJJJJJJJJMJMJJ
AAAAAAAAAAAAAAAAADDGGGGGGGJJJJJJJJJJJJJJJMJMMMJJJJ
AAAAAAAAAAAAAAAAAAGGGGGGGGGGJJJJJJJJJJJJMMJMJJJJJJ
AAAAAAAAAAAAAAAAAADGGGGGGGJJJJJJJJJJJJJJJJJMJJJJJJ
AAAAAAAAAAAAAAAAAAADDGGGJJJJJJJJJJJJJJJJJJJMJJMMJM
AAAAAAAAAAAAAAAAAAAADGGJJJJJJJJJJJJJJJMJJJJJJJJMMM
AAAAAAAAAAAAAAAAAAAADGGJJJJJJJJJJJJJJJJJJJJJJMMMMM
DAAAAAAAAAAAAAAAAAAADGGJJJJJJJJJJJJJJJJJJJJJMMMJJM
GDDAAAAAAAAAAAAAAAAAGGGJJJJJJJJJJJJJJJJJJJJJMJJJJM
GDDAAAAAAAAAAAAAAAAAGGGJJJJJJJJJJJJJJJJJJJJJMMJJJJ
GGDDDDAAAAAAAAAAAAAAGGGGJJJJJJJJGGJJJJJJJJJJJJJJJJ
GGGDDDDAAAAAAAAAAAAADGGGGGJGGJGGGJJJJJJJJJJJJJJJJJ
GGGDDDDDDDAAAAAAAAAADGGGGGGGGGGGGGJJJJJJJJJJJJJJJJ
GGDDDDDGDAAAAAAAAAAADGGGGGGGJGGGGGGJJJJJJJJJJJJJJJ
DDDDDDDDDAAAAAAAAAADGGGGGGGGGGGGGGGJJJJJJJJJJJJJJJ
DDDDDDDDDAAADDAAAADGGGGGGGGGGGGGGGGGGJJJJJJJJJJJJJ
GGDDDDGGDDDDDDDDDDDGGGGGGGGGGGGGGGGGGGJJJGJGJJJJJJ
GGDDDDGGGDGGGDDDGDDGGGGGGGGGGGGGGGGGGGGJGGJGJJJJJJ
GGDDDDGGGGGGGDDDGGDDGGGGGGGGGGGGGGGGGGGGGJJJJJJJJJ
GGGDDGGGGGGGGGGDDDDGGGGGGGGGGGGGGGGGGGGGGGGJJJJJJJ
GGGGGGGGGGGGGGGDDGGGGGGGGGGGGGGGGGGGGGGGGGGGJJJJJJ
GGGGGGGGGGGGGGGGDDDGGGGGGGGGGGGGGGGGGGGGGGGGJJJJJJ
GGGGGGGGGGGGDGGDDDDGGGGGGGGGGGGGGGGGDGGGGGGGJJJJJJ
GGGGGGGGGGGGDDDDDDGGGGGGGGGGGGGGGDGDDGGGGGGGGGJJJJ
GGGGGGGGGGGGDDDDDGGGGGGGGGGGGGGGGDDDDGGGGGGGGGJJJJ
GGGGGGGGGGGGGDDDGGGDDDGGGGDDDGGGGGDDDGGGGGGGGGGJJJ
GGGGGGGGGGGGGDDDDDDDAADDDDDDDDDDGDDDDGGGGGGGGGGGJJ
GGGGGGGGGGGGDDDDDDAAAAAAAAAAAADDDDADAADGGGGGGGGJJJ
GGGGGGGGGGGGGDDDDAAAAAAAAAAAAAAADDAAAAADGGGGGGGGJJ
GGGGGGGGGGGGGDDAAAAAAAAAAAAAAAAAADAAAAADDGGGGGGGGJ
GGGGGGGGGGDDDAAAAAAAAAAAAAAAAAAAAAAAAAAADGGGGGGGGG
GGGGGGGGGGDAAAAAAAAAAAAAAAAAAAAAAAAAAAAADGGGGGGGGG
GGGGGGGGGDAAAAAAAAAAAAAAAAAAAAAAAAAAAAADDDGGGGGGGG
GGGGGGGGGDAAAAAAAAAAAAAAAAAAAAAAAAAAAAADDGGGGGGGGG
GGGGGGGGGDAAAAAAAAAAAAAAAAAAAAAAAAAAAAAADGGGGGGGGG
GGGGGGGGGDAAAAAAAAAAAAAAAAAAAAAAAAAAAAADDGGGGGGGGG
GGGGGGGGGDDAAAAAAAAAAAAAAAAAAAAAAAAAAAAADDGGGGGGGG
GGGGGGGGGDDDAAAAAAAAAAAAAAAAAAAAAAAAAAAADDDGGGGGGG
GGGGGGGGGGGGAAAAAAAAAAAAAAAAAAAAAAAAAAAAAAADGGGGGG
GGGGGGGGGGDDAAAAAAAAAAAAAAAAAAAAAAAAAAAAAAADGGGGGG
GGDDDDGGGGDDAAAAAAAAAAAAAAAAAAAAAAAAAAAAAAADGDGDGG
GDDDDDDDDDDDDAAAAAAAAAAAAAAAAAAAAAAAAAAAAAADDDDDDD
DDDDDDDDDDDDAAAAAAAAAAAAAAAAAAAAAAAAAAAAAAAADDDDDG
DDDDDDDDDDDDDAAAAAAAAAAAAAAAAAAAAAAAAAAAAAAAADDDDG
