JJJJJJJJJJJJJGGGDAAAAAAAAAAAAAAAAAAAAAAAAAAAAAAAAA
JJJJJJJJJJJJJGGGDAAAAAAAAAAAAAAAAAAAAAAAAAAAAAAAAA
JJJJJJJJJJJJJGGGDAAAAAAAAAAAAAAAAAAAAAAAAAAAAAAAAA
JJJJJJJJJJJJJJGGGDDDDDAAAAAAAAAAAAAAAAAAAAAAAAAAAA
JJJJJJJJJJJJJJGGGGGGDAAAAAAAAAAAAAAAAAAAAAAAAAAAAA
JJJJJJJJJJJJJJJGGGGGGDAAAAAAAAAAAAAAAAAAAAAAAAAAAA
JMJJJJJJJJJJJJJGGGGGGGDAAAAAAAAAAAAAAAAAAAAAAAAAAD
JMJMJJJJJJJJJJJJJJGGGGGDAAAAAAAAAAAAAAAAAAAAAAAADG
JJJMJJJJJJJJJJJJJJJJGGGGDAAAAAAAAAAAAAAAAAAAAAADGG
MMJMMJJJJJJJJJJJJJJJJGGGGAAAAAAAAAAAAAAAAAAAAAADGG
MMMMJJJJJJJJJJJJJJJJJJGGGDAAAAAAAAAAAAAAAAAAAAADGG
MMMMMMMJJJJJJJJJJJJJJJJGGDDDAAAAAAAAAAAAAAAAAADDGG
MMMMPMMMMJJJJJJJJJJJJJGGGGDDAAAAAAAAAAAAAAAAADDGGG
PPMPPPMMMJJJJJJJJJJJJJJJGGGGDAAAAAAAAAAAADDDDDDGGG
PPPPPPPMMJJJJJJJJJJJJJJJJJGGDAAAAAAAAADDDDDDDDDGGG
PPPPPPPMMMMMJJJJJJJJJJJJJJGGGGDAAAADGGGGGGGGGGGGGG
PPPPPPPPMMMJJJJJJJJJJJJJJJJGGGGGGGGGGGGGGGGGGGGGGG
PPPPPMMMMMJJJJJJJMJJJJJJJJJJGGGGGGGGGGGGGGGGGGGGGG
PPMPPPPMMMMMJJJJMMMMMMJJJJJJJJGGGGGGGGGGGGGGGGGGJJ
MMPPPPMPMJMJMMMMMMMMMMMMJJJJJJJGGGGGGGGGGGGGGGGGJJ
MMPMMMMMMMJMMMMMMMMMMMMMMJJJJJJGGGGGGGGGGGGGGGJGJJ
PPPPMMMMJJMMMMMMPMMMMMMMMJJJJJJGJJGGGGGGGJJJJJJJJJ
PPPPMMMMJMMMMMMMMMMMMMMMMJJJJJJJJJGGGGGJJJJJJJJJJJ
PPMPPPMMMMMMMMMMMMMMMMMMMMJJJJJJJJGGGGJJJJJJJJJJJJ
PPMPMPMMMMMMMMMMMMMMMMMMMMJJJJJJJJJGGGJJJJJJJJJJJJ
PPPMMMMMMMJMMMMMMMJMMMMMMMJJJJJJJJJJGGGJJJJJJJJJJJ
PPMMMPMMMMJMJMMJJMJMMMMMMMMJJJJJJJJJGGGJJJJJJJJJJJ
MMMMMPMMMMMJMJJMJMJMMMMMMMMJJJJJJJJGGGGGGJJJJJJJJJ
MMMMPPMMMMMJJJJJMMMMMMMJMJMMJJJJJJJGGJGGGGGJJJJJJJ
MMMMMPMMMMMJJJJMMMMMMJJJJJMJJJJJJJJJGGGGGGJJJJJJJJ
MMMMMMMMMJJJJJJJMMJMJJMMMMMJJJJJJJJGGGGGJJJJJJJJJJ
MJMMMMMMMJJJJJJJJJMJJMMMMMMJJJJJJJGGGGGGJJJJJJGGJJ
JJJJMMMMJJJJJJJJJJJJJMMMMMJJJJJJJJGGGGGGJJJJGGGGGG
JJJJJJJJJJJJJJJJJJJJJMMMMMJJJJJJJJGGGGGGGGGGGGGGGG
JJJJJJJJJJJJJJJJJJJJMMMMMJJJJJJJJJGGGGGGGGGGGGGGGG
GGJJJJJJJJJJGJJJJJJJJJMJJJJJJJJJJJJGGGGGGGGGGGGGGG
GGGGJJJJJJJGGJJJJJJJJJJJJJJJJJJJJJGGGGGGGGGGGGGGGG
GGGGJJJJJGGGGGJJJJJJJJJJJJJJJJJJJJGGGGGGGGGGGGGGGG
GGGGJJJJJGGGGGGJJJJJJJJJJJJJJJJJJJGGGGGGGGGGGGGGDD
GGGGGGGGGGGGGGGGJJJJJJJJJJJJJJJJJJGGGGGGGGGGGGDDAA
GGGGGGGGGGGGGGGGGGJJJJJJJJJJJJJJJJGGGGGGGGDGDDDAAA
ADDDDDDGGGGGGGGGGGJJJJJJJJJJJJJJJJGGGGGGGGDAAAAAAA
AAAAAAADDDDDDDGGGGJJJJJJJJJJJJJJJGGGGGGGDDDAAAAAAA
AAAAAAAAADDDDDGGGGGJJJJJJJJJJJJJJJGGGGGGGDAAAAAAAA
AAAAAAAAADDDDDDGGGGJJJJJJJJJJJJJJJGGGGGGGDAAAAAAAA
AAAAAAAAAAADADDGGGGJJJJJJJJJJJJJJJJGGGGGGGDAAAAAAA
AAAAAAAAAAADDDGGGGGGJJJJJJJJJJJJJJJJJGGGGGGAAAAAAA
AAAAAAAAAAADDGGGGGGGGJJJJJJJJJJJJJJJJJJGGGDAAAAAAA
AAAAAAAAAAAADGGGGGGGGGGJJJJJJJJJJJJJJJJGGGAAAAAAAA
AAAAAAAAAAADDGGGGGGGGGGJJJJJJJJJJJJJJJJGGGGAAAAAAA
