MJJJJJJJJJJJJJJJJJJJJJJJJJGGGGJJJJJJJJJJGGGGGGGGGG
JJJJJJJJMJJJJJJJJJJJJJJJJJGGGJJJJJJJJJJJGGGGGGGGGG
JJJJJJMMMJJJJJJJJJMMMMJJJJJJJJJJJJJJJJJJGGGGGGGGGG
JJJJJMJJJJJJJJJJJMMMMJJJJJJJJJJJJJJJJJJJGGGGGGGGGG
JJJJJJJJJJJJJJJJJMMJMJJJJJJJJJJJJJJJJJJJGGGGGGGGGG
JJJJJJJJGJJJJJJJJMMJJJJJJJJJJJJJJJJJJJJJJGGGGGGGGG
JJJJJJJGGJJJJJJJJMJJJJJJJJJJJJJJJJJJJJJJJJJJGGGGGG
JJJJJJJGGJJJJJJJJJJJJJJJJJJJJJJJJJJJJJJJJJJJJJGGGG
JJJJJJJGGGGGJJJJJJJJJJJJJJJJJJJJJJJJJJJJJJJJJJJGGG
JJJJJJJJGGGGJJJJJJJJJJJJJJJJJJJJJJJJJJJJJJJJJJJGGG
JJJJJJJJJGGGGJJJJJJJJJJJJJJJJJJJJJJJJJJJJJJJJJJGGG
JJJJJJGGGGGGGGJJJJJJJJJJJJJJJJJJJJJJJJJGJJJJJJJGGG
JJJJJGGGGJJJJGJJJJJJJJJJJJJJJJJJJJJJJJGGGGGGGGGGGG
GGJJJJGGGGJJJGGJJJJJJGGGGJJJJGJGGGJGGGGGGGGGGGGGGG
GGGGGGJGGGJJGGGJJJJJGGGGGGGGGGGGGGGGGGGGGGGGGGGGGG
JJGGGGGGGGGJJJJJGJJGGGGGGGGGGGGGGGGGGGGGDDGGGGGGGG
JJJGGGGGGGJJJJJJJJJGGGGGGGGGGGGGGGGGGGGGGDADGDDGGG
JJJJJGGGGGJJJJJJJJGGGGGGGGGGGGGGGGGGGDGGDDADDDDDDD
JJJJJGGGGGGGJGGGJJGGGGGGGGGGGGGGGGGDDDDDAAAAAAAAAA
JJJJJJJGGGGGGGGGGGGGGGGGGGGGGGGGDDADAAAAAAAAAAAAAA
JJJJJJJJGGGGGGGGGGGGGGGGGGGGGGDDAAAAAAAAAAAAAAAAAA
JJJJJJJJJJGGGGGGGGGGGGGGGGGGGGGDDAAAAAAAAAAAAAAAAA
JJJJJJJJJJJJGGGGGGGGGGGGGGGGGGGDAAAAAAAAAAAAAAAAAA
JGJJJJJJJJJJJGGGGGGGGGGGGGGGGGGDAAAAAAAAAAAAAAAAAA
JJGGJJJJJJJJJJGGGGGGGGGGGGGGGGGDAAAAAAAAAAAAAAAAAA
JJJJJJJJJJJJJJGGGGGGGGGGGGGGGGDDAAAAAAAAAAAAAAAAAA
JJJJJJJJJJJJJJGGGGGGGGGGGGGGGDAAAAAAAAAAAAAAAAAAAA
JJJJJJJJJJJJJJGGGGGGGGGGGGGGGDAAAAAAAAAAAAAAAAAAAA
JJJJJJJJJJJJJJJJGGGGGGGGGGGGGGDAAAAAAAAAAAAAAAAAAA
JJJJJJJJJJJJJJJJJJJJGGGGGGGGGGGDAAAAAAAAAAAAAAAAAA
JJJJJJJJJJJJJJJJJJJJGGGGGGGGGGGDAAAAAAAAAAAAAAAAAA
JJJJJJJJJJJJJJJJJJJGGGGGGGGGGGGDAAAAAAAAAAAAAAAAAA
JJJJJJJJJJJJJJJJJJJJJJGGGGGGGGGDAAAAAAAAAAAAAAAAAA
JJJJJJJJJJJJJJJJJJJJJJGGGGGGGGGDAAAAAAAAAAAAAAAAAA
JJJJJJJJJJJJJJJJJJJJJGGGGGGGGGGDDAAAAAAAAAAAAAAAAA
MJJJJJJJJJJJJJJJJJJJJGGGGGGGGGGGDAAAAAAAAAAAAAAAAA
JMMMJJJJJJJJJJJJJJJJJGGGGGGGGGGGDAAAAAAAAAAAAAAAAA
JMMJJJJJJJJJJJJJJJJJJJGGGGGGGGDDDAAAAAAAAAAAAAAAAA
JJMJJJJJJJJJJJMJJJJJJGGGGGGGGDDDAAAAAAAAAAAAAAAAAA
MJJJJJJJJJJJJJMJJJJJJGGGGGGGDAAAAAAAAAAAAAAAAAAAAA
MJJJJJJJJJJJJJJJJJJJJGGGGGGDAAAAAAAAAAAAAAAAAAAAAA
JJJMMMJJJJJJJJJJJJJJJGGGGGGDAAAAAAAAAAAAAAAAAAAAAA
JJMMMJJMMMJMJJJJJJJJJJGGGGDDAAAAAAAAAAAAAAAAAAAAAA
JMMJJJJMMMMMMMMJJJJJJJGGGDAAAAAAAAAAAAAAAAAAAAAAAA
MMMJJMJMMMMMMMMJJJJJJGGGGAAADDDAAAAAAAAAAAAAAAAAAA
MMMMMJMMMMMMMMMJJJJJGGGGGDDDDGGDAAAAAAAAAAAAAAAAAA
MMMJJMMMMMMMMMMMJJJJGGGGGGDDGGGGAAAAAAAAAAAAAAAAAA
MMMMJMMMMPPPMMMJJJJJGJJGGGGGGGGGDADAAAAAAAAAAAAAAA
MMMMJJMPPPPPMMMJJJJJJJJJGGGGGGGGGGGDAAAAAAAAAAAAAA
JJJMMJJMMPMMPMJJJJJJJJJJJJGJGGGGGGGGDAAAAAAAAAAAAA
