GDDDDAAAAAAAAAAAADDDGDDGGGGGGGGGGJJJJJJMMMMPPPPPPP
DDDDAAAAAAAAAAAAADGGDDGGGGGGGGGJJJJJJJJJMMMPPPPPPP
DDDDAAAAAAAAAAAAADDDDGGGGGGGGGJJJJJJJJJJJMMPPPPPPP
GGGDAAAAAAAAAAAAAADADGGGGGGGGGJJJJJJJJJJJMMMMPPMPM
GGGGDAAAAAAAAAAAAAADDGGGGGGGJJJJJJJJJJJJJJMMMMPMMM
GGGGGDAAAAAAAAAAAADDDDGGGGGJJJJJJJJJJJJJJJJJMMPPMM
GGGGGDDAAAAAAAAAADDDDGGGGGGJJJJJJJJJJJJJJJJJJMMMMM
GGGGGGDAAAAAAAAAADDDDDGGGGGGJJJJJJJJJJJJJJJJJMJMMM
GGGGGGGAAAAAAAAAAAAAAADGGGGGJJJJJJJJJJJJJJJJJMJJMJ
GGGGGGDDAAAAAAAAAAAAAAAGGGGGGGJJJJJJJJJJJJJJMMMJMM
GGGGGDAAAAAAAAAAAAAAAAAAGGGGJGGJJJJJJJJJJJJMJJMMPP
GGGGGDAAAAAAAAAAAAAAAAADGGGGGGGGJJGJJJJJJJJJJJJMPP
GGGGDDAAAAAAAAADAAAADADGGGGGJGGGGGGGGJJJJJJJMJMMPP
GGGGDAAAAAAAAAAAAAAAADDGGGGGGGGGGGGGGGGJJJJMMMMMPP
GGGDDAAAAAAAAAAAAAAAADDGGGGGGGGGGGGGGGJJJJJJMMMMPP
GGDDDAAAAAAAAAAAAAAADDDGGGGGGGGGGGGGJJJJJJJMMMPPPP
GGDDDDAAAAAAAAAAAAAAADGGGGGGGGGGGGGJGJJJJJMMMPPPPP
DDDDDAAAAAAAAAAAAAAAAAGGGGGGGGGGGGGJJJJJJJMMMPMPMP
DDDDDAAAAAAAAAAAAAAAADGGGGGGGGGGGGGGJJJJJJJMMMMPPP
DDAAAAAAAAAAAAAAAAAAADGGGGGGGGGGGGGJJJJJJJJMMMMPPP
AAAAAAAAAAAAAAAAAAAADGGGGGGGGGGGGGGJJJJJJJJMMMMMPP
AAAAAAAAAAAAAAAAAAADDGGGGGGGGGGGGGJJJJJJJMMMJMMMPP
AAAAAAAAAAAAAAAAAAADGGGGGGGGGGGJJJJJJJJJJMMMMMMMMP
AAAAAAAAAAAAAAAAAAADGGGGGGGGGGGJJJJJJJMMMMMMMPPMMM
AAAAAAAAAAAAAAAAAAAADDDDGGGGGGGJJJJJJJMMMMPMMPPMMM
AAAAAAAAAAAAAAAAAAAAAAAADGGGGGGJJJJJJMMMMMPPPPPPMM
AAAAAAAAAAAAAAAAAAAAAAAAADDGGGGJJJJJJJMMMMMPMPPMMM
AAAAAAAAAAAAAAAAAAAAAAAAAADGGGGGJJJJJJMMMMMMMMMPMM
AAAAAAAAAAAAAAAAAAAAAAAAAAAGGGGGGJJJJJJMMMJMMMMMMM
AAAAAAAAAAAAAAAAAAAAAAAAAAADGGGGGGGJJJJJMJJMMMMMMM
AAAAAAAAAAAAAAAAAAAAAAAAAAAAGGGGGGGJJJJJJJJMMMMMMM
AAAAAAAAAAAAAAAAAAAAAAAAAAAADGGGGGGJJJJJJJJMMMMMMM
AAAAAAAAAAAAAAAAAAAAAAAAAAAAADGGGGGGJJJJJJJJMMMMMM
AAAAAAAAAAAAAAAAAAAAAAAAAAAAADGGGGGGGJJJJJJJJMMJMM
AAAAAAAAAAAAAAAAAAAAAAAAAAAAAADDGGGGGJJJJJJJJJJJJJ
AAAAAAAAAAAAAAAAAAAAAAAAAAAAAADDGGGGGJJJJJJJJJJJJJ
AAAAAAAAAAAAAAAAAAAAAAAAAAAAAADDGGGGGJJJJJJJJJJJJJ
AAAAAAAAAAAAAAAAAAAAAAAAAAAAAAADGGGGGJJJJJJJJJJJJJ
AAAAAAAAAAAAAAAAAAAAAAAAAAAAAADDGGGGJJJJJJJJMMMJJJ
AAAAAAAAAAAAAAAAAAAAAAAAAADDDDDGGGGGJJJJJJJJJJJJJJ
AAAAAAAAAAAAAAAAAAAAAAADDDDGGGGGGJJJJJJJJJJJJJMMJJ
AAAAAAAAAAAAAAAAAAAAAADGGGGGGGGGGJJJJJJJJJJJJJMMMM
AAAAAAAAAAAAAAAAAAAAAAGGGGGGGGGGJJJJJJJJJJJJMMMMJJ
AAAAAAAAAAAAAAAAAAAAADGGGGGGGGJJJJJJJJJJMMMMMMMMJJ
AAAAAAAAAAAAAAAAAAAADGGGGGGGGJJJJJJJJJJJMMMMMMMMMJ
AAAAAAAAAAAAAAAAAAADDGGGGGJJJJJJJJJJJJJJMJJJMMMMMM
AAAAAAAAAAAAAAAAAAADDGGGGGJJJJJJJJJJJJJJMJJJMMMMJM
AAAAAAAAAAAAAAAAAAADGGGGGGJJJJJJJJJJJJJJMMJJMMMMMM
AAAAAAAAAAAAAAAAAAADGGGGGJJJJJJJJJJJJJJJJJJJJMMMMM
AAAAAAAAAAAAAAAAAAADGGGGJJJJJJJJJJJJJJJJJJJJMMMMMM
