JJJJJJJJMJJJJJJJMJJJJJJMMMMMMPMMPPPPPPPPPPPPPPPPMM
GJJJJJJJJMJJJJJJJJJJJJJJJJMJMMMPPPPPPPPPPPPPPPPPJJ
GGJJJJJJJJJJJJJJJJJJJJJMJMJJMMMMPPPPPPPPPPPPPMPMMJ
GJJJJJJJJJJJJJJJJJJJJJJMJJJJJMPMPPPPPPPPPPPPPPPPPP
GJJJJJJJJJJJJJJJJJJJJJJMJJJJJPPMPPPPPPPPPPPPPPPPJJ
GGGGJJJJJJJJJJJJJJJJJJJJJJJMPPMPPPPPPPPPPPPPPPMMPP
GGGGJJJJJJJJJJJJJJJJJJJJJMJJMMMMPPPPPPPPPPPPPPPPMJ
GGGJJJJJJJJJJJJJJJJJJJJMMMMMMPMPPPMPPPPPPPPPPPPPPP
GGJJJJJJJJJJJJJJJJJJJJJMMMMMMPPPPPPPPPPPPPPPPPPPPP
GGGJJJJJJJJJJJJJJJJJJJJMMMJMMPPPPPPPPPPPPPMMPPPPPM
GGJJJJJJJJJJJJJJJJJJJJJMMMJMMMMPPMMMPPPPPPPPMPPMMJ
GGJJJJJJJJJJJJJJJJJJJJJMMMMPMPPMPPPPPPPPPPPPMPMMMM
GJJJJJJJJJJJGGJJJJJJJJJMMPPPMPPPPPPPPPPPPPPPMJMMJM
GGJJJJJJJJJJGGJJJJJJJJMMMMPPPPPMPPPPPPPPPPPMMMPMJJ
GGGGJJJJJJGGGGJJJJJJJJMMMPPPPPPPPPPPPPPPPPPMMMMMJJ
GGGGGJJGGGGGGGJJJJJJJMMMMMPPMPPPPPPPPPPMPPPPMMJJJJ
GGGGGGGGGGGGGGJJJJJJJJMMMPPPMPPPMMMMMPPMMMPMMMJJJJ
GGGGGGGGGGGGGGJJJJJJJMMMMMMPMMMPMMMMPMMMMMMMMMJJJJ
GGGGGGGGGGGGGGJJJJJJJMJMMMMMMJJMMMMMMMMMMMMMMJJJJJ
GGGDDDDGGGGGGGJJJJMJJJJJJMMMJJMMMMMMMMJMMMMMJJJJJJ
DDDDDAADGGGGGGJJJJJJJJJJJJJMMJJJMJJMMMJMMMMMJJJJJJ
DAAAAAAADGGGGGGJJJJJJJJJJJJJJJMMMMMMJMMMPMMMMJJMJJ
DAAAAAAAADGGGGGGGJJJJJJJJJJJJJMMMMJMJMMPPMMMJMMMJM
AAAAAAAAADDDDDGGGGJJJJJJJJJJJJJJMMJJMPPPPPMMMMMMJJ
AAAAAAAAAAAADDGGGGJJGGJJJJJJJJJJMJMJMMMPPPMMMMMJJJ
AAAAAAAAAAAAAADDGGGGGGGJJJJJJJJJMMMMMMPPPPMMMMJJJJ
AAAAAAAAAAAAAAAADGGGGGGGGJGGJJJJJMMMMPMPPPPMMMMMJJ
AAAAAAAAAAAAAAAAAGGGGGGGGGGGGJJJJMMMMPMMMPMMMMMMMJ
AAAAAAAAAAAAAAAAADGGGGGGGGGGJJJJMMMMMMMMPPPPMMMMMJ
AAAAAAAAAAAAAAAAAAADGGGGGGGGJJJJJMMMMMMMMMMMMMMMMM
AAAAAAAAAAAAAAAAAAAADGGGGGGGGJJJJJMMMMMMMMMMMMMMMM
AAAAAAAAAAAAAAAAAAAADGGGGGGGJJJJJJJJJMJMMMMJMMMMMM
AAAAAAAAAAAAAAAAAAAADDGGGGGGJJJJJJJJJJJJJMJJJJMMJJ
AAAAAAAAAAAAAAAAAAAAAAAGGGGGJJJJJJJJJJJJJJJJJJJMJJ
AAAAAAAAAAAAAAAAAAAAAAADGGGGGJJJJJJJJJJJJJJJJJJJJJ
AAAAAAAAAAAAAAAAAAAAAADGGGGGGJJJJJJJJJJJJJJJJJJJJJ
AAAAAAAAAAAAAAAAAAAAAADDGGGGGJJJJJJJJJJJJJJJJJJJJJ
AAAAAAAAAAAAAAAAAAAAAADGGGGGGJJJJJJJJJJJJJJJJJJJJJ
AAAAAAAAAAAAAAAAAAAAAADGGGGGJJJJJJJJJJJJJJJJJJJJJJ
AAAAAAAAAAAAAAAAAAAAAADGGGGJJJJJJJJJJJJJJJJJJJJJJJ
AAAAAAAAAAAAAAAAAAAAAADGGGJJJJJJJJJJJJJJJJJJJJJJJJ
AAAAAAAAAAAAAAAAAAAAAADGGGJJJJJJJJJJJJJJJJJJJJJJJJ
AAAAAAAAAAAAAAAAAAAAAADGGGJJJJJJJJJJJJJJJJJJJJJJJJ
AAAAAAAAAAAAAAAAAAAAADGGGGGJJJJJJJJJJJJJJJJJJJJJJJ
AAAAAAAAAAAAAAAAAAAAADDGGGGJJJJJJJJJJJJJGGJGGJJJJJ
AAAAAAAAAAAAAAAAAAAAADDGGGGJJJJJJJJJJJJJJGGGGGGGGJ
AAAAAAAAAAAAAAAAAAAAAADGGGJJJJJJJJJJJJJJJGGGGGGGGG
AAAAAAAAAAAAAAAAAAAAAADGGGJJJJJJJJJJJJJJJGGGGGGGGG
AAAAAAAAAAAAAAAAAAAAAADGGGJJJJJJJJJJJJGGGGGGGGGGGG
AAAAAAAAAAAAAAAAAAAAAAGGGGJJJJJJJJJJGGGGGGGGGGGGGG
