MJJJJJJJJJJJJJGGGGGGGGGGGGDAAAAAAAAAAAAAAAAAAAAAAA
JJJJJJJJJJJJJJGGGGGGGGGDDAAAAAAAAAAAAAAAAAAAAAAAAA
JMJJJJJJJJJJJJGGGGDDGGDAAAAAAAAAAAAAAAAAAAAAAAAAAA
MMMJJJJJJJJJJJJGGGDDDDAAAAAAAAAAAAAAAAAAAAAAAAAAAA
MMMMJJJJJJJJJJJGGGDAADAAAAAAAAAAAAAAAAAAAAAAAAAAAA
MMMMMJJJJJJJJJJGGGGAAAAAAAAAAAAAAAAAAAAAAAAAAAAAAA
MMMMMMJJJJJJJJGGGGGDAAAAAAAAAAAAAAAAAAAAAAAAAAAAAA
MMMMMMMJMJJJJJJGGGGDAAAAAAAAAAAAAAAAAAAAAAAAAAAAAA
JMMMMJMMJJJJJJGGGGGGAAAAAAAAAAAAAAAAAAAAAAAAAAAAAA
MJMJJJMMJJJJJJGGGGGGDAAAAAAAAAAAAAAAAAAAAAAAAAAAAA
MJJJJJMMJJJJJJJGGGGGDAAAAAAAAAAAAAAAAAAAAAAAAAAAAA
MJJJJJJJJJJJJJJGGGGGGDDAAAAAAAAAAAAAAAAAAAAAAAAAAA
MMJJJJJJJJJJJJGGGGGGGGGAAAAAAAAAAAAAAAAAAAAAAAAAAA
MJMJJJJJJJJJJJJGGGGGGGGDAAAAAAAAAAAAAAAAAAAAAAAAAA
MMMJJMJJJJJJJJJGGGGGGDDAAAAAAAAAAAAAAAAAAAAAAAAAAA
MMJJJJMJJJJJJJJGGGGGGDDDDDAAAAAAAAAAAAAAAAAAAAAAAA
PMJJJMMJJJJJJJJJJJGGGADDDDAAAAAAAAAAAAAAAAAAAAAAAA
PMMJJMMJJJJJJJJJJJJGGGDDGDAAAAAAAAAAAAAAAAAAAAAAAA
PMMJMJJJJJJJJJJJJJJGGGGGGDAAAAAAAAAAAAAAAAAAAAAAAA
PMMMJJJJJJJJJJJJJJJGGGGGGGDAAAAAAAAAAAAAAAAAAAAAAA
PMMJJJJJJJJJJJJJJJJGGGGGGGGDAAAAAAAAAAAAAAAAAAAAAA
MMMMJJJJJJJJJJJJJJJGGGGGGGGGAAAAAAAAAAAAAAAAAAAAAA
PMMMJJGJJJJJJJJJJJJJJJGGGGGGGDDDAAAAAAAAAAAAAAAAAA
PPMMMJJJJJJJJJJJJJJJJJJJGGGGGGGDAAAAAAAAAAAAAAAAAA
PMJJJJJJJJJJJJJJJJJJJJJJJGGGGGGDAAAAAAAAAAAAAAAAAA
PMJJJJJJJJJJJJJMJJJJJJJJJJJGGGGGDDAAAAAAAAAAAAAAAA
PMJJJJJJJJJJJJJJMJJJJJJJJJJGGGGGGGGDDDADAADDAAAAAA
MMJJJJJJJJJJJJJJJJJJJJJJJJJGGGGGGGDDDDAADDDDDAAAAA
MJJJJJJJJJJJJJJJJJJJJJJJJJJJGGGGGDDDDDDADDDDDDAAAA
MJJJJJMMMMMMJJJJJJJJJJJJJJJJJGGGGDDDDDDADDDDDDDDDA
MJJJJJJJJMMMMMMJJJJJJJJJJJJGGGGGGDDDDDDDDDDDDDGGDD
MJJJJJJJMMMMMMMMJJJJJJJJJJGGGGGGGDDDDGDDGGGDGGGGGD
MJJJJJJMMMMMMMMMMJJJJJJJJJGGGGGGGGGDGGGGGGGGGGGGGD
JJJJJJJJMMMMMMJMMJJJJJJJGGGGGGGGGGGGGGGGGGGGGGGGGD
MJMJJJJMMMMMMMMMJJJJJJJJGGGGGGGGGGGGGGGGGGGGGGGGDD
JMMJJJJMMPPPMMMMMJJJJJJGGGGGGGJGGGGGGGGGGGGGGGGGGD
JMMMJJMMMPMPMMMMMJJJJJJGGJJGGJJJJGGGGGGGGGGGGGGGGG
JJMMJJMMMMMMMMMMJJJJJJJJJJGJJJJJJJJJJJJGGGGGGGGGGG
MMMJJJJMJMMMMMJJJJJJJJJJJJJJJJJJJJJJJJJJJGGGGGGGGG
JJJJJJJJJJMMMMMJJJJJJJJJJJJJJJJJJJJJJJJJJJGGGGGGGG
JJGJJJJJJJJJJMMJJJJJJJJJJJJJJJJJJJJJJJJJJJGGGGGGGG
JJGGJJJJJJJJMJJJMMJMJJJJJJJJJJJJJJJJJJJJJJJGGGGGGG
JJGGGGGJJJJJJJJJMMMJJJJJJJJJJJJJJJJJJJJJJJJGGGGGGJ
JJGJGJJGJJMMJJJJMMJJJJJJJJJJJJJJJJJJJJJJJJJJGGJJJJ
JJGGGGJJJGJJMMJJMMJMJJJJJJJJJJJJJJJJJJJJJJJJJJJJJJ
JJJGJGGJGGJJMMJJMJMJJJJJJMMJJJMMJMJJJJJJJJJJJJJJJJ
JJJJJJJJJGGJJJJJJJJJJJJJJMJMJMJMMMJMMMMMJJJJJJJJJJ
JJJMJJGJJJJJMJJJJJMJMJJJMMMJMMMMMMMMMMMMJJJJJJJJJJ
JJMMMMJJJJMMJJJJJJJMJJMMMMMMMMMPMMMMMMMMJMJJJJJJJJ
MJMMMMJJJJJMMMJJJJJJJJJMMMMPMMMMPMMMMMMMMMMJJJJJJJ
