GGGGGGGGAAAAAAAAAAAAAAAAAAAAAAAAAAAAAAAAAADDDDDGGG
GGGGGGGAAAAAAAAAAAAAAAAAAAAAAAAAAADDDDDDAAAADDDDGG
GGGGGGAAAAAAAAAAAAAAAAAAAAAAAAAAAADGDDGDDADAAAADGG
GGGGGGAAAAAAAAAAAAAAAAAAAAAAAAAAADDGGGDDDDAAAADDDG
GGGGAAAAAAAAAAAAAAAAAAAAAAAAAAAAADGGGGDDDDDDDADGGG
GGGAAAAAAAAAAAAAAAAAAAAAAAAAAAAAADGGGDDGDDDGDGGGGG
GGAAAAAAAAAAAAAAAAAAAAAAAAAAAAAAADDGGGGGDDDGGGGGGG
GAAAAAAAAAAAAAAAAAAAAAAAAAAAAAAADDDGGGGGGGGGGGGGGG
GAAAAAAAAAAAAAAAAAAAAAAAAAAAAAADGGGGGGGGGGGGGGGJGG
AAAAAAAAAAAAAAAAAAAAAAAAAAAAAADDGGGGGGGGGGGGGGGJJJ
AAAAAAAAAAAAAAAAAAAAAAAAAAAAAAADGGGGGGGGGGGGGGJJJJ
AAAAAAAAAAAAAAAAAAAAAAAAAAAAAADGGGGGGGGJGGGGGGGGJJ
AAAAAAAAAAAAAAAAAAAAAAAAAADAADDGGGGGGJJJJGGGGGGGJJ
AAAAAAAAAAAAAAAAAAAAAAAADDDDDDGGGGJJJJJJGGGGGGGJJJ
AAAAAAAAAAAAAAAAAAAAAAAADGGGGGGGGGJJJJJJGGGGJJJJJJ
AAAAAAAAAAAAAAAAAAAAAAADGGGGGGGGGGJJJJJJGGGGJJJJJJ
AAAAAAAAAAAAAAAAAAAAAAADGGGGGGGGGJJJJJJJGGGGJJJJJJ
AAAAAAAAAAAAAAAAAAAAAAADGGGGGGGGGGJJJJJJJJJJJJJJJJ
AAAAAAAAAAAAAAAAAAAAAAADGGGGGGGGGGJJJJJJJJJJJJJJMJ
AAAAAAAAAAAAAAAAAAAAADDGGGGGGGGGGGGJJJJJJJJJJJJJJJ
AAAAAAAAAAAAAAAAAAAADDGGGGGGGGGGGGGJJJJJJJJJJJJJJJ
AAAAAAAAAAAAAAAAAAADDGGGGGGGGGGGGJJJJJJJJJJJJJJMJJ
AAAAAAAAAAAAAAAAAAADGGGGGGGGGGGGGJJJJJJJJJJJJJJMMJ
AAAAAAAAAAAAAAAAAAAGGGGGGGGGGGGGGJJJJJJJJJJJJJJMMM
AAAAAAAAAAAAAAAAAAADGGGGGGGGGGGGGJJJJJJJJJJJJJJMMM
AAAAAAAAAAAAADAAAAADGGGGGGGGGGGGJJJJJJJJJJJJJJMMPM
AAAAAAAAAAAAADDDAADGGGGGGGGGGGGGJJJJJJJJJJJJJJJMMM
AAAAAAAAAADDDDDDDDGGGGGGGGJGGGGJJJJJJJJJJMMJJJJMMM
AAAAAAAAADGGGGDADDGGGGGGJGGGGJJJJJJJJJJJMMMMJJJJJM
AAAAAAADDGGGGGGGDDGGGGGGJJJJJJJJJJJJJJJMMMJJJMJMMM
AAAAAADDGGGGGGGGGGGGGGGJJJJJJJJJJJJJJJJMMMMMMMMMMP
AAAADDDDGGGGGGGGGGGGGJGJJJJJJJJJJJJMJJMMMMMMMMMMMM
DAGGGGGGGGGGGGGGGGGGGGJJJJJJJJJJJJJMJJJMMMMPPPMPPP
GGGGGGGGGGGGGGGGGGGGGGJJJJJJJJJJJJJJJJJMMMMPPPMMPP
GGGGGGGGGGGGGGGGGGGGGJJJJJJJJJJJJJJJJJMMMMPPPPPPPP
GJJJGGGGGGGGGGGGGGGGGJJJJJJJJJJJJJJJJJJMMPMPPMPMMP
JJGJGGGGGGGGGGGGGGGGGJJJJJJJJJJJJJJJJJJMMMMMJMMPPP
JJGGGGGGGGGGGGGGGGGGGJJJJJJJJMMJJJJJJJJMMMMJJJMMJM
JJGGGGGGGGGGGGGGGGGGGJJJJJJJJJMMMJJJJJMMMJMMMMMPMM
JJJGGGGGGGGGGGGGGGGGGJJJJJJJJJMMMJJJJJJJJJJJMMJPPP
JJJGGGGGGGGGGGGGGGGGGGJJJJJJJJJJMMJJJJJJJJJJMMMPMP
JJJGGGJJGGGGGGGGGGGGGGGGJJJJJJJJJJJJJJJJJJJMMJMMPP
JJJGGGJGGGGGGGGGGGGGGGGGGJJJJJJJJJJJJJJJJJJMPMMPPM
JJJJGGGGGGGGGGGGGGGGGGGGGJJJJJJJJMMJJJJJJJJMMMMMMM
JJJJJGGGGGGGGGGGGGGGGGGGGGJJJJJJMMMMMMMJMJJJMMMJMJ
JJJJJJGGGGGGGGGGGGGGGGGGGGJJJJJJJMMMMJMMMMJJMMMJMM
JMJJJJJGGGGGGGGGGGGGGGGGGJJJJJJJJJMMMMMMMMMMJJMMMM
MMMJJJJGGGGGGGGGGGGGGGGGGGJJJJMJJJMMMMMMMMMJJMMJMM
MMMMJJJJGGGGGGGGGGGGGGGGGGJJJJJJJMMMMMMMMMMJJJMJMM
MMMMJJJJGGGGGGGGGGGGGGGGGJJJJJJJJJJJMMMMMMJJMJJJMM
