PPPPPPPPMMMMJMMJJJJJMJJJJJJJJJJMMMMMMPMMPPPPMMMPPP
PPPPPPPPPPPMMMMMJJJJJJJJJJJJMJMMMMJJMMPMPMMPPPPPPP
PPPPPMMPPPPMMMMMJJJJJJJJJJJMMMMMMJMMPPPPPMMMPPPPPP
PPPPPMMPPPMPPPMJJJJJJJJJJJMMMMMMMJJMPPPPPPPPPPPPPP
PPPPPPJMMJMMPPMMJJJJJJMJJMJMPPMMPMMMMPPPMPPPPPPPPP
PPMMPPMMMJJMMMMMJMMMJJJJJMMMMPPMPJMMMJMPPMPPPPPPPP
PPMPMPMMMMJJPPMMMJJJJJJJJJJMMMPPPPMMPPPPPPPPPPPPPP
PMPMMMPMMPMPPMMMMJJJJJJJJJJMJMMPPMJMPPPPPPPPPPPPPP
PPPPMPMMMPMMMMJMMJJJJJJJJJJJJMMPPPMPPPPPPPPPPPPPPP
PPMPMMPMMMMMMMJMJJJJJJJGJJJJJMMPPPPPPPPPPPPPPPPPPP
MMPMPPMMMPMPMMMJJJJJJJGJJGJJJJMMPPPPPPPPPPPPPPPPPM
PPPPMMMMMPPJJMJMJJJJJJGGGJGJJJMMMMMMPPPPPPPPPPPPPP
PPPMMMMJMMPMMMMMMJJJJJJJGJJJJJJMMMMMPPPPPPPPPPPPPP
PMMMMMMMMMMMMMMMMMJJJJJJJJJJJJJJJJMJMMMPPPPPPMMPPP
MMMJMMJMMMMMMMMMMMMMJJJJJJJJJJJJJJMMMMMMMMMPMMMMJM
JMJJJJMJJMJMMMMMMMMMJJJJJJJJJGJJJJJMJJMMMMPPPMPMMM
JJJJJJJJJJMMMMMMMMMMMMMJJJJJJJJJJJJJJJJJJMMMMMMMMM
JMJJJJMMMMMMMMMMMMMMJMMMJJJJJJJJJJJJJJJJJJJJMMMJMM
MMMMJJMJMJMMMMMMMMMMMMMMJJJJJJJJJJJJJJJJJJJJJJJMMJ
JMMJJJJJJJMJJMMMMMMJJMMMJJJJJJJJJJJJJJJJJJJJJJJJMJ
MJJMMJJJJJJJMJJMMMJJJJMMJJJJJJJJJJJJJJJJJGGJGGJJJJ
JJJJMJJJJMJJJJJMMMJJJJJMMJJJJJJJJJJJJJJJGGGGGJJJJJ
JJJJJJJJJMMJJJJJJJJJJJJJMJJJJJJJJJJJJJJJGGGGGGGGGG
JJJJJJJJJJJJJJJJJJJJJJJJJJJJJJJJJJJJJJJJGGGGGGGGGG
JJJJJJJJJJJJJJJJJJJJJJJJJJJJJJJJJJJJJJJJJJJGGGGGGG
JJJJJJJJJJJJJJJJJJJJJJJJJJJJJJJJJJJJJJJJJJJJGGGGGG
JJJJJJJJJJJJJJJJJJJJJJJJJJJJJJJJJJJJJJJJJJJJJJGGGJ
JJJJJJJJJGGGGGGGJJJJJJJJJJJJJJJJJJJJJJJJJJJJJJJJGJ
JJJJJGJGGGGGGGGGGGGGGJJJJJJJJJJJJJJJJJJJJJJJJJJJJJ
JJJJGGGGGGGGGGGGGGGGJGGGGGJJJJJJJJJJJJJJJJJJJJJJJJ
JJJJGGGGGGGGGGGGGGGGGGGGGGGGJJJJJJJJJJJJJJJJJJJJJJ
GGGJGGGGGGGGGGGDDGGGGGGGGGGGGGJJJJJJJJJJJJJJJJJJJJ
GGGGGGGGGGGGGGGDDGGGGGGGGGGGGGGJJGGGJJJJJJJJJJJJJJ
GGGJGGGGGGGDGGGADDGGDDDDGGGGGGGGGGGGJJJJJJJJJJJJJJ
GGGGGGGGGGDDGGGAAADAADDDGGGGGGGGGGGJJJJJJJJJJJJJJJ
GGGGGGGGGGDDGGDDAAAAAAAAAGGDGGGGGGGGGJJJJJJJGGGGGG
GGDGGGGGGDDDDDDAAAAAAAAAADDDDDGGGGGGGGGJJJJJGGGGGG
GDDAAADDAAAAAAAAAAAAAAAAAAAAAADGGGGGGGGJJJJJJGGGGG
GDDAAAAAAAAAAAAAAAAAAAAAAAAAAAADGGGGGGGGJJJJGGGGGG
GAAAAAAAAAAAAAAAAAAAAAAAAAAAAAADDGGGGGGJJJJJGGJGGG
DAAAAAAAAAAAAAAAAAAAAAAAAAAAAAAAAGGGGGGGGJJJJGGGGG
DAAAAAAAAAAAAAAAAAAAAAAAAAAAAAAAADGGGGGGGJJJJGGGGG
DAAAAAAAAAAAAAAAAAAAAAAAAAAAAAAAADGGGGGJGJJGGGGGGG
AAAAAAAAAAAAAAAAAAAAAAAAAAAAAAAADDGGGGGGGGGGGGGGGG
AAAAAAAAAAAAAAAAAAAAAAAAAAAAAAAAADDGGGGGGGGGGGGGGG
AAAAAAAAAAAAAAAAAAAAAAAAAAAAAAAAADDGGGGGGGGGJGGGGG
DDDAAAAAAAAAAAAAAAAAAAAAAAAAAAAAADDGGGGGGGGGJGGGGG
DDDDAAAAAAAAAAAAAAAAAAAAAAAAAAAAAADDDGDGGGGJJJJJJG
GDDDDAAAAAAAAAAAAAAAAAAAAAAAAAAAAAAAADGGGGJJJJJJJJ
GDDDDAAAAAAAAAAAAAAAAAAAAAAAAAAAAAAAADGGGJJJJJJJJJ
