PPMPPPPPMPPPPPMMMMMJJJJJJJJJGGGGGGGDDDDDDDDADDDDDD
MMMPPPMMMMMMMMMMMMMMJJJJJJJJJGGGGGGDDDDDDDDADDDDDD
MMMPPPMMMMMMMMMMJJJJJJJJJJJJJJGGGGGGDDDDDDDDDDGDDD
MMPPPMMPPMMJMMMJJJJJJJJJJJJJJGGGGGGGGGGGDDDDGDGGDD
MMPPPPPPPMMJMMJJJJJJJJJJJJJJGJGGGGGGGGGDDDDDDGGGGG
MMMMMPPMMJJMJJJJJJJJJJJJJJJGGGGGGGGGGGGGDDDDDGGGGG
JMMMMMMMMJMJJJJJJJJJJJJJJJJJGGGGGGGGGGGDDDDDDDDGGG
JMMJMMMMMJJJJJJJJJJJGGJJJJJJJGGGGGGGDDDDDDDDDDDDGG
JJJJMMMMJMMMJJJJJJJJGGJJJJJJJGGGGGGGDDDDDGGDDDDGGG
JJJMJMMMMMMMJJJJJJJGGGJGJJJJJGGGGGGGDDDDDGGGGGDGGG
MMJMJMMMMMMMMJJJJJJGGGGGGJJJJJJJGGGGDDDDGGGGGGGGGG
MJMMMJJMMMMMMMJJJJGGGGGGGGGJJJJJGGGGDDDDGGGGGGGGGG
MMMJMMJJMMJJJJJJGGGGGGGGGGGGJJJJGGGGGGGGGGGGGGGGGG
MMMMJJJMMMJJJJJJGGGGGGGGGGGGJJJGGGGGGGGGGGGGGGGGGG
MMMMJJMMMJJJJJJJGGGGGGGGGGGGGJGGGGGGGGGGGGGGGGGGGG
JMMJJJMJJJJJJJGGGGGGGGGGGGGGGJJGGGGGGGGGGGGGGGGGGG
JJJJJJJJJJJGGGGGGGGGGGGGGGGGGGGGGGGGGGGGGGGGGGGGGG
JJJJJJJJJJJGGGGGGGGGGGGGGGGGGGGGGGGGGGGGGGGGGGGGGG
MJJJJJJJJJJGGGGGGDDDDGGGGGGGGGGGGGGGGGGGGGGGGGGGGG
MMMJJJJJJJJGGGGGGAAAAAGGGGGGGGGGGGGGGGGGGGGGGGGGGG
MMJJJJJJJGGGGGGDDAAAAAGGGGGGGGGGJJJGJJJGGGGGGGGGGG
JMJJJJJJJGGGGGDDAAAAAAGGGGGGGGGGJJGGGJJGGGGGGGGGGG
JJJJJJJJGGGGGDDDAAAAAAAAADGGGGGJGGGGGGJJGGGGGGGGGG
JJJJJJJJGGGGGDDDAAAAAAAAAADGGGGJGGGGGGGJJGGGGGGGGG
JJJJJJJJGGGGGGGDAAAAAAAAAADGGGGGGGGGGGGGGGGGGGGJJJ
JJJJJJJJJGJGGGDDAAAAAAAAAAGGGGGGGGGGGGGGGGGGGGJJJJ
GGGJJJJGGGGGGGDAAAAAAAAAAADGGGGGGGGGGGGGGGGGGGJGJJ
GGGGGGGGGGGGGGDAAAAAAAAAAAGGGGGGGGGGGGGGGGGGGGGGJJ
GGGGGGGGGGGGGDDAAAAAAAAAADGGGGGGGGGGGGGGGGGGGGGGGJ
GGGGGGGGGGGGDAAAAAAAAAAAADDGGGDDDDGGGGGGGGGGGGGGGJ
ADDDDGGGGGGDAAAAAAAAAAAAAAADDDDDDDGGGGGGGGGGGGGGGJ
AAAADGGGGGGGAAAAAAAAAAAAAAADDDAAADGGGGGGGGGGGGGGGJ
AAAADGGGGGGDAAAAAAAAAAAAAAAADAAAAADGGGGGGGGGGGGGJJ
AAAAADDGGGGDAAAAAAAAAAAAAAAAADAAAADGGGGGGGGGGGJJJJ
AAAAAAAGGGGDAAAAAAAAAAAAAAAAAAAAAAGGGGGGGGGGGGGJJJ
AAAAAAAADDDDDAAAAAAAAAAAAAAAAAAADDGGGGGGGGGGGGGJJJ
AAAAAAADDDAAAAAAAAAAAAAAAAAAAAAADGGGGGGGGGGGJGJJJJ
AAAAAAAADDAAAAAAAAAAAAAAAAAAAAADDGGGGGGGGGGGJJJJJJ
AAAAAAAAAAAAAAAAAAAAAAAAAAAAAAAAGGGGGJJGGGGGJJJJJJ
AAAAAAAAAAAAAAAAAAAAAAAAAAAAAAAGGGGGGGJJGGGJJJJJJJ
AAAAAAAAAAAAAAAAAADDDAAAAAAAAADGGGGGGGJJJGJJJJJJJJ
AAAAAAAAAAAADDAADDGGDDADDDAAADGGGGGGGJJJJJJJJJJJJJ
AAAAAAAAAAADDDDDGGGGGGGGGDDDDDGGGGGGJJJJJJJJJJJJJJ
AAAAAAAAAAAADDDDDDGGGGGGGGDGGGGGGGGGJJJJJJJJJJJJJJ
AAAAAAAAAAAAADDDDDDGGGGGGGGGGGGGGGJJJJJJJJJJJJJJJJ
AAAAAAAAAAAAADDADDDGGGGGGGGGGGGGGJJJJJJJJJJJJJJJJJ
AAAAAAAAAAAAAAADDGGGGGGGGGGGGGGGGJJJJJJJJJJJJJJJJJ
AAAAAAAAAAAAAAAADGGGGGGGGGGGGGGGGGJJJJJJJJJJJJJJJJ
AAAAAAAAAAAAAAADDGGGGGGGGGGGGGGGGJJJJJJJJJJJJJJJJJ
AAAAAAAAAAAAAAADDGGGGGGGGGGGGGGGGJJJJJJJJJJJJJJJJJ
