GGGGGGGGGGGGGGGGGGGDDDDGGGGGGGGGJJJJJJJJJMMMMMJJMM
GGGGGGGGGGGGGGDDDGDDDDDGGGGGGGGGJJJJJJJJJMJMMJJJMM
GGGGGGGGGGGDAAAADDDGDDDGGGGGGGGGGJJJJJJJJJJMMMMMMJ
GGGGGGGGGGDAAAAADDDDDDDGGGDGGGGGGJJJJJJJJJJMMMMMMJ
GGGGGGGGGGDAAAAAADDAAADGGGGGGGGGGGGGJJJJJJMMMJJJJJ
GGGGGGGGGDDAAAAAAAAAAAADDDGGGGGGGGGJJJJJJMMMMMMJJJ
GGGGGGGGGGDAAAAAAAAAAAADDDGGGGGGGGJJJJJJJMMMMMJJJJ
GGGGGGGGGGDAAAAAAAAAAADGGGGGGGGGGGJJJJJJJMMMMMMJJM
GGGGGGGGGGDAAAAAAAAAAAAGGGGGGGGGJJGGJJJJJMMMMJMMMM
GGGGGGGGGGGDAAAAAAAAAAADGGGGGGGGJJGGJJJJMMJMMJMMMM
GGGGGGGGGGGDAAAAAAAAAAADGGGGGGGGGGJJJJJJJJJJMMMMMM
GGGGGGGGGGGGAAAAAAAAAADGGGGGGGGGGGJJJJJJJJJJMMJJMM
GJJJGGGGGGGGDAAAAAAAAAADDDDDDADGGGGJJJJJJJJJJJJJJJ
GJJJGGGGGGGGDAAAAAAAAAAADDAAAAADGGGGJJJJJJJJJMMMJJ
GGGGGGGGGGGDDAAAAAAAAAAAAAAAAAAADGGGGGGJJJJJJJJJJJ
GGGGGGGGGGGDAAAAAAAAAAAAAAAAAAAAAGGGGGGGGJJJJJJJJJ
GGGGGGGGGGGDAAAAAAAAAAAAAAAAAAAAADGGGGGGGGGJJJJJJJ
GGGGGGGGGGGDDAAAAAAAAAAAAAAAAAAAAAADGGGGGGGGGGJGJJ
GGGGGGGGGGGGDDAAAAAAAAAAAAAAAAAAAAAADGGGGGJGGGGJJG
GGGGGGGGGGGGGDAAAAAAAAAAAAAAAAAAAAAADGGGGGGGGGGGGG
JGJJGGGGGGGGGDAAAAAAAAAAAAAAAAAAAAAAADDADGGGGGGGGG
JJJJJGGGGGGGGDAAAAAAAAAAAAAAAAAAAAAAAAAAAADGDGGGGG
JJJJJGGGGGGGGDAAAAAAAAAAAAAAAAAAAAAAAAAAAAAAADGGGG
JJJJJJGGGGGGGDAAAAAAAAAAAAAAAAAAAAAAAAAAAAAAADDGGG
JJJJJJGGGGGGDDAAAAAAAAAAAAAAAAAAAAAAAAAAAAAAADDGGG
JJJJJJGGGGGGDDAAAAAAAAAAAAAAAAAAAAAAAAAAAAAAAADDDG
JJJJGJGGGGGGDDAAAAAAAAAAAAAAAAAAAAAAAAAAAAAAAAAADA
JJJJGGGGGGGGDDAAAAAAAAAAAAAAAAAAAAAAAAAAAAAAAAAAAA
JJJGGGGGGGGGDDAAAAAAAAAAAAAAAAAAAAAAAAAAAAAAAAAAAA
JJJJJGGGGGGGGDAAAAAAAAAAAAAAAAAAAAAAAAAAAAAAAAAAAA
JJJJJGGGGGGGGGDAAAAAAAAAAAAAAAAAAAAAAAAAAAAAAAAAAA
JMJJJJJGGGGGGGGDDAAAADDAAAAAAAAAAAAAAAAAAAAAAAAAAA
MJJJJJJJGGGGGGGGGDDAADDDAAAAAAAAAAAAAAAAAAAAAAAAAA
MJJJJJJJJJJGGGGGGGGDDGDDAAAAAAAAAAAAAAAAAAAAAAAAAA
MMJJJJJJJJJJJGGGGGGGGDDDAAAAAAAAAAAAAAAAAAAAAAAAAA
MMJJJJJJJJJJJJJGGGGGGGDDDAAAAAAAAAAAAAAAAAAAAAAAAD
MMMMMMJMJJJJJJJJGGGGGGGGDAAAAAAAADAAAAAAAAAAAAAAAD
MMMMMMMMJJJJJJJJGGGGGGGGGGADDAAADDDDAAAAAAAAAAAAAA
MMMMMMMMJJJJJJJJGGGGJGGGGGGGDDAADDDAAAAAAAAAAAAAAA
MMMMMJJJJJJJJJJJGGGGJJGGGGGGGDDDDDDDDAAAAAAAAAAAAA
MMMMMMJJJJJJJJJJGGGGJJJGGGGGGGDDDDDDDDAAAAAAAAAAAA
MMMMJJJJJJJJJJGGGGGGJJJJJGGGGGGGDDDDDAAAAAAAAAAAAA
MMMJJJJJJJJJJJJJGGGJJJJJJJJGGGGGGGDDDDAAAAAAAAAAAA
MMMMJMJJJJJJJJJJJJJJJJJJJJJJGGGGGGGGGDDDAAAAAAAAAA
MMMMMMJJJJJJJJJJJJJJJJJJJJJJJGGGGGGGGGDDAAAAAAAAAA
MMMPMMMMJMJJJJJJJJJJJJJJJJJJJJGGGGGGGGGGGDAAAAAADA
MMPMPMMMMMJJJJMJJJJJJJJJJJJJJJJGGGGGGGGGGDDDDADDDA
PMMPPPPMMMMMMMMMMMMMMJJJJJJJJJJJGGGGGGGGGGGGDDADDD
PPPPPPPMJMMMMMMMMMMMMJJJJJJJJJJJGGGGGGGGGGGGDDADDD
PPPPPPPMMMMMMMPMMMMMMJJJJJJJJJJJGGGGGGGGGGGGDAADGG
