PPMMJJMMMMMMMMJJJJJJJJJJJJJJMMJMMMMMMMMMMMPPMMMMMJ
PPMJMMMMMMMMMJJJJMJJJJJJJJJJMMMMMMMMMMMMPMMMPMMMMM
PPMMJMMMMMMMMJJJJJJJJJJJJJJJMMMMMMMMMMMMMMMPMMMMJM
PPPMMJMMMMMJJJJJJJJJJJJJJJJJJMMMMMMJMMMMMMMMMMMJMM
PMMMMJMMMMMJJJJJJJJJJJJJJJJJJMMMMMJMMMMMMMPMMMMMMM
PMMMMMMMMMMJJJJJJJJJJJJJJJJJJMMMMMJMMMMMMMPMPMMMMM
PPMJJJMMMJJJJJJJJJJJJJJJJJJJJJJMMMJMMMMMPPPPPMMMJJ
MMJJMJMMMMMJJJJJJJJJJJJJJJJJJJJJMMJMMMMPPMPPPMMMMM
MJMJJJJJJJMMJJJJJJJJJJJJJJJJJJJJJJJJJMMMMMPMMMMMMJ
MMMJJJJJMJJJJJJJJJJGGGJJJGJJJJJJJJJJJJMMMMMMMMMMMM
PMMJJJJJMJJJJJJJJJGGGGJGGJJJJJJJJJJJJJJMMMMMMMMMMJ
PMMJJJJJJJMJJJJJJGGGGGGGGJJJJJJGGGGGJJJJJMMMMMMMMM
PMMJMJJJJJJMJJJJGGGGGGGGGGGGGGGGGGGJJJJJJJJJMJJJJJ
PMMMJJJJJJJJJJJJGGGGGGGGGGGGJGGGGGGGJJJJMJMJJJJJJJ
MMMJJJJJJJJJJJJJGGGGGGGGGGGGJGGGGGGGJJJMJMJJJJJJJJ
MMMMJJJJJJJJJJJGGGGGGGGGGGGGGGJGGGGJJJJJJJJJJJJJJJ
PPMMJJJJJJJJJGGGGGGGGGGGGGGGGGGJGJGJJJJJJJJJJJJGGG
PPMMJJJJJJJGGGGGGGGGGGGGGGGGGGGGGGGGJJJJJJJJJJGGGG
PMMMJJJJJJJJGGGGGGGGGGGGGGGGGGGGGGGGGJJJJJJJJJJGGG
PMMMJJJJJJJGGGGGGGGGDDGGGGGGGGGGGGGGGGJJJJJJJJGGGG
MMMMJJJJGJGGGGGGGGGGDDDDGGGGGGGGGGGGGGJJJGJGJGGGGG
MMMMJJJGGGGGGDDGGGDDDDDDDDDDGGGGGGGGGGJJGGGGGGGGGG
MMMMJJJGGGGGGDDDDDDDDDDDDDADDGGGGGGGGGGGGGGGGGGGGG
MMMMJJJJGGGGGGGAAAAAAAAAAAAAADGGGGGGGGGGGGGGGGGGGG
JJMJJJJGGGGGGGGDAAAAAAAAAAAAAADDGGGGGGGGGGGGGGGGGG
MJJJJJJJGGGGGGGDDAAAAAAAAAAAAAADDDDDGGGGGGGGGGGGGG
JJJJJJJJGGGGGGGGDAAAAAAAAAAAAAADDGGDDGGGGGGGGGGGGG
JJJJJJJJGGGGGGGGDAAAAAAAAAAAAAAADGGGGGGGGGGGGGGGGG
JJJJJJGGGGGGGGGGDAAAAAAAAAAAAAAADGGGGGGGGGGGGGGGGG
JJJJJJGGGGGGGGGGGAAAAAAAAAAAAAAADGGGGGGGGGGGGGGGGG
JJJJGGGGGGGGGGGGDAAAAAAAAAAAAAAAADGGGGGGGGGGGGGGGG
JJJJGGGGGGGGGGGGDAAAAAAAAAAAAAAAADGGGGGGGGGGGGGGGG
JJJJGGGGGGGGGGGDAAAAAAAAAAAAAAAAAADGGDGGGGGGGGGGGG
JJJJJJGGGGGGGGDAAAAAAAAAAAAAAAAAAAADDDADGGGGGGGGGG
JJJJJJJGGGGGGGDAAAAAAAAAAAAAAAAAAAAAAAAADGGGGGGGGG
JJJJJJJGGGGGGGAAAAAAAAAAAAAAAAAAAAAAAAAAAADGGGGGGG
JJJJJJJGGGGGDDAAAAAAAAAAAAAAAAAAAAAAAAAAAAADGGGGGG
JJJJJJJGGGGGDAAAAAAAAAAAAAAAAAAAAAAAAAAAAAADDGGGGG
JJJJJJGGGGGGAAAAAAAAAAAAAAAAAAAAAAAAAAAAAAAADDDDDD
JJJJJJGGGGGAAAAAAAAAAAAAAAAAAAAAAAAAAAAAAAAAAADDDA
JJJJJGGGGGDAAAAAAAAAAAAAAAAAAAAAAAAAAAAAAAAAAAADAA
JJJJGGGGGGAAAAAAAAAAAAAAAAAAAAAAAAAAAAAAAAAAAAAAAA
JJJJJGGGDAAAAAAAAAAAAAAAAAAAAAAAAAAAAAAAAAAAAAAAAA
JJJJJGGGDAAAAAAAAAAAAAAAAAAAAAAAAAAAAAAAAAAAAAAAAA
JJJJJGGGGDAAAAAAAAAAAAAAAAAAAAAAAAAAAAAAAAAAAAAAAA
JJJJJJGGGDDAAAAAAAAAAAAAAAAAAAAAAAAAAAAAAAAAAAAAAA
JJJJJJGGGGDAAAAAAAAAAAAAAAAAAAAAAAAAAAAAAAAAAAAAAA
JJJJJJJGGGGDAAAAAAAAAAAAAAAAAAAAAAAAAAAAAAAAAAAAAD
JJJJJJJJGGGDAAAAAAAAAAAAAAAAAAAAAAAAAAAAAAAAAADDDD
JJJJJJJJJGGGAAAAAAAAAAAAAAAAAAAAAAAAAAAAAAAAAADDGG
