AAAAAAAAAAAAAAAAAAADDDDDDDDDDDDDGGDDDAAAAAADGGGGGG
AAAAAAAAAAAAAAAAAAAADDGDDDDDDDDDDADAAAAAAAAADDDDGG
AAAAAAAAAAAAAAAAAAAAADDDDDDDDDDDAAAAAAAAAAAAAADDDG
DADDGGDDAAAAAAAAAAAAADDDDDGGDDDDDAAAAAAAAAAAAAAAAD
DGGGGGGGDAAAAAAAAAAAAADDGGGGDDDDDAAAAAAAAAAAAAAAAA
GGGGGGGGGDDAAAAAAAAAAADDDDDDDADDAAAAAAAAAAAAAAAAAA
GGGGGGGGGGDAAAAAAAAAAAADDDDDDAAAAAAAAAAAAAAAAAAAAA
GGGGGGGGGGGDDDDDAAAAAAAAAADDDADDDDAAAAAAAAAAAAAAAA
GGGGGJJGGGGGGGDDDDAAAAAAAAAADDDDDDDAAAAAAAAAAAAAAA
JJJJJJJJJGGGGGGGGAAAAAAAAAAAADDDDDAAAAAAAAAAAAAAAA
JJJJJJJJJJGGGGGGDAAAAAAAAAAAAADDDDAAAAAAAAAAAAAAAA
JJJJJJJJJJJJGGGGGDAAAAAAAAAAAADGGDAAAAAAAAAAAAAAAA
JJJJJJJJJJJJJJGGGDAAAAAAAAAAADDDDDAAAAAAAAAAAAAAAA
JMMMJJJJJJJJJJJGGGDDDAAAAAAAADADDDAAAAAAAAAAAAAAAA
MMMJJJJJJJJJJJJGGGGGGGDDAAAAAADDDDAAAAAAAAAAAAAAAA
JMMMMMJJJJJJJJJJGGGGGGGGDAADADDDDAAAAAAAAAAAAAAAAA
MMMMMMMJJJJJJJJGGGGGGGGGDDDDDDDDDAAAAAAAAAAAAAAAAA
JMMJMMJJJJJJJJJJJJJJGGGGGGDGDDDDDAAAAAAAAAAAAAAAAA
MMMMJJJJJJJJJJJJJJJJGGGGGGGGGDDDDAAAAAAAAAAAAAAAAA
JMMMJJJJJJJJJJJJJJJJJGGGGGGGDDDDDDAAAAAAAAAAAAAAAA
JMMMJJJJJJJJJJJJJJJJJJJGGGGGGDDDDDAAAAAAAAAAAAAAAA
JMJMJJJJJJJJJJJJJJJJJJJGGGGGGDDDDDAAAAAAAAAAAAAAAA
JJJJJJJJJJJJJJJJJJJJJJJJJJGGGGDDDAAAAAAAAAAAAAAAAA
JJJJJJJJJJJJJJJJJJJJJJJJJJJJGGGDDAAAAAAAAAAAAAAAAA
JJJJJJJJJJJJJJJJMJJJJJJJJJJJGGGDDAAAAAAAAAAAAAAAAA
JJJJJJJJJJJJJJJMMJJJJJJJJGGGGGGDAAAAAAAAAAAAAAAAAA
JJJJJJJJJJJJJMMMMMJJJJJJJGGGGGGDAAAAAAAAAAAAAAAAAA
JMJJJJJJJJJJJMMMMJJJJJJJJGGGGGGAAAAAAAAAAAAAAAAAAA
MMJMJJJJJJJJJJJJMMJJJJJJJGGGGGDAAAAAAAAAAAAAAAAAAA
JMJMJJJJJMMJJJJMJMMJJJJJJJGGGGDAAAAAAAAAAAAAAAAAAA
JJJJJJMJMJJJJJJJMMMJJJJJJJJGGGGDAAAAAAAAAAAAAAAAAA
JMMJJJMMMMJJMJJMMMJJJJJJJJJGGGGDAAAAAAAAAAAAAAAAAA
JMMMJMMMMMMJMMJMMMMMJJJJJJJGGGGDDDDAAAAAAAAAAAAAAA
MMMMMMMPMJJJJMMMMMMMMJJJJJJGGGGDDGDAAAAAAAAAAAAAAA
MMMMMMMMMMJJMMMMMMMMMJJJJJJJGGGGDDAAAAAAAAAAAAAAAA
MPMMJMMMMMMJMMMMMJMJJJJJJJJGGGGGDAAAAAAAAAAAAAAAAD
PMPMJMMMJJMMPPPMMMMJJJJJJJJGGGGGGGAAAAAAAAAAAAADDD
PPPPMMMMJMMMMPMPMMMJJJJJJJJJGGGGGGGAAAAADGGGGDDDDG
PPPPMMMPMMMPMMPPPMMMMJJJJJJJGGGGGGGGGGGDDGGGGDDDDG
PPPPPPPMPMMMMPPPPMJJMJJJJJJJGGGGGGGGGGGDGGGGGGDDDG
PPPPPPPPPMMMMMMMMJMJJJJJJJGJGGGGGGGGGGGGGGGGGDDDGG
PPPPPPPPPMMJJJMMJJJJJJJJJJJGGGGGGGGGGGGGGGGGGGDDGG
PPPPPPPPPMMMJMMMMMJMJJJJJJJJGGGGGGGGGGGGGGGGGDDDGG
PPPPPPPPPPMMJMMJMJJMMJJJJJJJJGGGGGGGGGGGGGGGDDDDGG
PPPPPPPPPPMMMMMJMJJMMMJMJJJJJGGGGGGGGGGGGGGGDDDDGG
PPPPPPPPPPMPPJJJMMMMMPMJJJJJJJJGGGGGGGGGGGGGDDDDDG
PPPPPPPPPPPPMPMMMMMMMMMMJJJJJJJJGGGGGGGJJJGGGDDGGG
PPPPPPPPPPPPPJPPMMMPPMMJJJMJJJJJJGGGGJGGJJGGGGGGGG
PPPPPPPPPPPPPPPPMPMPMMMMMMMJMJJJJGGGGGJJJGGGGGGGGG
PPPPPPPPPPPPPMPPMMPMMMJJMMMMJJJJJJJJGJJJJGGGGGGGGJ
