GGGGGGGGJGGGGGGGGGDDDAAADDGGGGDDAAAAAAAAAAAAAAAAAA
GGGGGGGJJGGGGGGGGGDDAAAAADGDDDDAAAAAAAAAAAAAAAAAAA
GGGGGGGGJGGGGGGGGDAAAAAAAAADDDAAAAAAAAAAAAAAAAAAAA
GGGGGGGGGGGGGGDDDAAAAAAAAAAAAAAAAAAAAAAAAAAAAAAAAA
GGGGGGGGGGGGGGDAAAAAAAAAAAAAAAAAAAAAAAAAAAAAAAAAAA
JJGGGGGGGGGGGGDAAAAAAAAAAAAAAAAAAAAAAAAAAAAAAAAAAA
JJGGGGGGJGGGGGDAAAAAAAAAAAAAAAAAAAAAAAAAAAAAAAAAAA
JJGJJGGGGGGGGGDDAAAAAAAAAAAAAAAAAAAAAAAAAAAAAAAAAA
JJJJJJJJJGGGGGGGDDAAAAAAAAAAAAAAAAAAAAAAAAAAAAAAAA
JJJJJJJJJJJGGGGGGGDDAAAAAAAAAAAAAAAAAAAAAAAAAAAAAA
JJJJJJJJJJJJGGGGGGGGGDAAAAAAAAAAAAAAAAAAAAAAAAAAAA
JJJJJJJJJJJJGGGGGGGGGDAAAAAAAAAAAAAAAAAAAAAAAAAAAA
JJJJJJJJJJJJJJGGGGGGGGDAAAAAAAAAAAAAAAAAAAAAAAAAAA
JJJJJJJJJJJJJJJJGGGGGGGDAAAAAAAAAAAAAAAAAAAAAAAAAA
JJJJJJJJJJJJJJJJGGGGGGGGDAAAAAAAAAAAAAAAAAAAAAAAAA
JJJJJJJJJJJJJJJJJJGGGGGGDAAAAAAAAAAAAAAAAAAAAAAAAA
JJJJJJJJJJJJJJJJJJJJJGGGGDAAAAAAAAAAAAAAAAAAAAAAAA
JJJJJJJJJJJJJJJJJJJJJJGGGDDAAAAAAAAAAAAAAAAAAAAAAA
JJJJJJJJJJJJJJJJJJJJJJJGGGGDDAAAAAAAADAAAAAAAAAAAA
JJJJJJJJJJJJJJJJJJJJJJJJJGGGGDDDDDDDDDAAAAAAAAAAAA
JJJJJMJJJJJJJJJJJJJJJJJJJJGGGGGGGGGDDDAAAAAAAAAAAA
JJJJJMMMJJJJJJJJJJJJJJJJJJJGGGGGGGGGGDAAAAAAAAAAAA
JJJJJJMJJJJJJJJJJJJJJJJJJJJGGGGGGGGGDDAAAAAAAAAAAA
JJJJJJJMJJMJJJJJJJJJJJJJJJJGGGGGGGGGDDDDAAAAAAAAAA
JJJJJJMMMMJJJJJJMJJJJJJJJJJJJGGGGGGDDDDDAAAAAAAAAA
JJJMMJMMMMMJJJJJJJJJJJJJJJJJJGGGGGGGGGDDAAAAAAAAAA
JJJMMMJMJMMMJJJJJJJJJMJJJJJJJJGGGGGGGGGDDDDDAAAAAA
JJMMMMJMJMMMJJJJJJJJJJJJJJJJJJGGGGGGGGGGGGGDAAAAAA
JJMMMJMJMMMJJJJJJJJJJJJJJJJJJJGGGJGGGGGGGGGGGGDAAA
JMMMMJJMMMMJJJJJJJJJJJJGJJJJJGGGJJJGGGGGGGGGGGGDAA
JMMMMMMMMMMMJJJJJJJJJJJGGGGGGGGGJJJJJGGGGGGGGGGGDD
JMMMMMMMMMMJMJJJJJJJJGJGGGGGGGGGJJJJJJJGGGGGGGGGGD
JMMMMMMMMMMMMJMJJJJJJGGGGGGGGGJJJJJJJJJJGGGGGGGGGD
MMMMMMMMMMMMMMMJJJJJJGGGGGGGGJJJJJJJJJJJGGGGGGGGDD
MMMMMMMMMMMMMMMMJJJJJJGGJJGGGGJJJJJJJJJJJGGGGGGGGA
MMMPPPPMMMMMMMMJJJJJJJJJJJJGJJJJJJJJJJJJJJGGGGGGGD
MMPMPPPMMMMJMMMJJJJJJJJJJJGGJJJJJJJJJJJJJJJGGGGGGD
MMPPPPPPMMMMMMMJJJJJJJJJJJJJJJJJJJJJJJJJJJJGGGGGDD
MMMPPPPPPPMJMMMMJMJJJJJJJJJJJJJJJJJJJJJJJJJGGGGGGG
MMMPPPPPPPMMMJJMMMMJJJJJJJJJJJJJJJJJJJJJJJJGGGGGGG
MMMMPPPPPPPMMJJMMMJJJJJJJJJJJJJJJJJJJJJJJJJJGGGGGG
PMMPPPPPPPMMJMMJJJJJJJJJJJJJJJJJJJJJJJJJJJJJJGGGGG
PPPPMPMMMMMMMJMJJJJJJJJJJJJJJJJJJJJJJJJJJJJJJJJJJJ
PPPMMMMMMMMMJJJJJJJJJJJJJJJJJJJJJJJJJJJMMMJJJJJJJJ
PPPMMMMMMMMMMMMMJJJJJJJJJJJJJJJJJJJJJMMMMMMJJJJJJJ
PPPMPMMMMPMMMMMMMJJJJJJJJJJJJJJMJJJJMMMMMMMJJJJJJJ
MMMMMMMMMMMMMMMMMMJJJJJJJJJJJJJMMMMMMMMMMMMMMJJJJJ
MMMMMMMMMJMMJMMMMJJJJJJJJJJJJMMMMMMMMMMMMMMMMJJJJJ
MMMMMMMJJJMJJMMMJJJJJJJJJMJJMMMMMPPPMMMMMMMMMMJJJJ
JMMMJMMMJMJJMJJJJJJJJJJJMMMMMMMMPPPPMMMMMMJMMJJJJJ
