GGGGGGGGGGGGGGGGGGGGDDDDDDDDDDDDDDDDDDDDDDGGGGDDDD
GGGGGGGGGGGGGGGGGGGGDDDDDDDDDDDDDDDDDDDDDDDDDDDDDD
GGGGGGGGGGGGGGGGGGDDDDDDDDDDDDDDDDDDDDDDDDDDDDDDDD
GGGGGGGGGGGGGGGGGGDDDDDDDDDDDDDDDDDDDDDDDDDDDDDDDD
GGGGGGGGGGGGGGGGGDDDDDDDDDDDDDDDDDDDDDDDDDDDDDDDDD
GGGGGGJGJGGGGGGGGDDDDDDDDDDDDDDDDDDDDDDDDDDDDDDDDD
GGGGGJJJJJGGGGGGGGDDDDDDDDDDDDDDDDDDDDDDDDDDDDDDDD
GGGGJJJJJJJGGGGGGGGDDDDDDDDDDDDDDDDDDDDDDDDDDDDDDD
JGGGJJJJJJJJJJGGGGGGDDDDDDDDDDDDDDDDDDDDDDDDDDDDDD
JJJJJJJJJJJJJJJGGGGGDDDDDDDDDDDDDDDDDDDDDDDDDDDDDD
JJJJJJJJJJJJJJJJGGGGDDDDDDDDDDDDDDDDDDDDDDDDDDDDDD
JJJJJJJJJJJJJJJJGGGGGDDDDDDDDDDDDDDDDDDDDDDDDDDDDD
JJJJJJJJJJJJJJJJJGGGGGGDDDDDDDDDDDDDDDDDDDDDDDDDDG
JMJJJJJJJJJJJJJJJJGGGGGGGDDDDDDDDDDDDDDDDDDDDDDDGG
JMMMJJJJJJJJJJJJJJJGGGGGGDDDDDDDDDDDDDDDDDDDDDDGGG
MMMMJJJJJJJJJJJJJJJJGGGGGGDDDDDDDDDDDDDDDDDDDDDGGG
MMMMJJJJJJJJJJJJJJJJJJGGGGGDDDDDDDDDDDDDDDDDDDDDGG
MMMMMMMJJJJJJJMJJJJJJJGGGGGDDDDDDDDDDDDDDDDDDDDGGG
MJMMMMJJJJJJJJMMJJJJJGGGGGGDDDDDDDDDDDDDDDDDDDGGGG
MJJJJJJJJJJJJJMJJJJJJGGGGGGGDDDDDDDDDDDDDDDDDDGGGG
MJJJJJJJJJJJJJJJJJJJJGGGGGGGDDDDDDDDDDDDDGGGGGGGGG
JJJJJJJJJJJJJJJJJJJJJGGGGGGGGDDDDDDDDDDGGGGGGGGGGG
MMMMMJJGJJJJJJJJJJJJJGGGGGGGGDDDDDDDDDGGGGGGGGGGGG
MMMJJGGGJJJJJJJJJJJJJGGGGGGGGDDDDDDDDGGGGGGGGGGGGG
MMJJJGGGGGGGJJJJJJJJJGGGGGGGDDDDDDDDDGGGGGGGGGGGGG
MMMJJGGGGGGJJJJJJJJJJGGGGGDDDDDDDDDDDGGGGGGGGGGGGG
MMMJJJGGGGGGJJJJJJJJJGGGGDDDDDDDDDDDDGGGGGGGGGGGGG
MMMMMJJJGGGGJJJJJJJJJJGGGGDGGGDDDDDDDGDGGGGGGGGGGG
MMMMMJJJJJJGJJJJJJJJJJGGGGGGGGGDDDDDDDDDGGGGGGGGGG
MMMMMMJJJJJJJJJJJJJJJJJGGGGGGGGDDDDDDDDDDGGGGGGGGG
MMMMMMMJJJJJJJJJJJJJJJJJJJGGGGGDDDDDDDDDDDDGGGGGGG
JMMMMMMJMMJMJJJJJJJJJJJJJJJGGGGGDDDDDDGGDDGGGGGGGG
MMJMMMMMMJJMJJJJJJJJJJJJJJJJJGGGDDDDGGGGDDDGGGGGGG
MMMMMMMMMMJMJJJJJJJJJJJJJJJJJGGGDDGDGGGGDDDGGGGGGG
MMMJJJMMMMJMJJJJJJJJJJJJJJJJJJGGGGGGGGGGGGGGGGGGGG
MMMMJMJMJMMMJJJJJJJMJJJJJJJJJJJGGGGGGGGGGGGGGGGGGG
JMJMMMJJJMMMMJJJJJJMMJJJJJJJJJJJGGGGGGGGGGGGGGGGGG
MPMPMMMJJJJJJJJMMMMMMJJJJJJJJJJGGGGGGGGGGGGGGGGGGG
MPMMMPMJMMJJMJJJJMJMMJJJJJJJJJJJGGGGGGGGGGGGGGGGGG
PJPPMMMJMJMMMJJMJMMJJJJJJJJJJJJJJGGGGGGGGGGGGGGGGG
MMPPPPMPPMMMMMJMJMMMJJJJJJJJJJJJGGJJGGGGGGGGGGGGGG
PPPPPPMMPMMMMMMMMMMMJJJJJJJJJJJJJJJJJJJGGGGGGGGGGG
PPPPPPPPPPPPPPPMMMJJMMJMMJJJJJJJJJJJJJJGGGGGGGGGGG
PPPPPPPPPPMMMMMMMMMMMMMMMMMJJJJJJJJJJJGGGGGGGGGGGG
PMPPPPPPPPPJMMMMMMJMMMMMMMMMJJJJJJJJJGGGGGGGGGGGGG
PPPPPPPPPMPPPPPJJPPPPPPPMMJMMJJJJJJJJGGGGGGGGGGGGG
PPPPPPPPPPPPPPMJPMPMPPPMMMMJJJJJJJJJJGGGGGGGGGGGGG
PPPPPPPPPPPPPMMPPMMMPPPMMMMJJJJJJJJJJJGGGGGGGGGGGG
PPPPPPPPPPPMPMPMMMPPPPPPPMMMMJJJJJJJJJGGGGGGGGGGGG
PPPPPPPPPPPPPMPMPPPPPPPPMMMMMJJJJJJJJJGGGGGGGGGGGG
