JJJJMMMMMMMMMMMMMMMJJJJJJJJJJJJJJJGGGGDDGGGGGGGGJJ
JJJMMMMMMMMMMMMMMMMJJJJJJJJJJJGGGGGGGDDDGGGGGGGGJJ
JJJJJJMMJJMJJMMMMMMJJJJJJJJJJJGGGGGGDDADDDGGGGGGJJ
JJJMMMMMMMMMMMMMMMMMJJJJJJJJJJGGGGGDAAAAADGGGGGGJJ
JJJMMMMMMMMMMMMMMMMMJJJJJJJJJJGGGGGAAAAAAADGGGGGJJ
JJJMMJJJJMMMMPPPMMMMJJJJJGJJJGGGGGDAAAAAAADDGGGJJJ
JJJMMJJMJJMMMMMMMMMMJJJJJJGGGGGGGGDAAAAAAADGGGGJGG
JJJMMMMMMJJJMMMMMMMJJJJJGGGGGGGGGGDAAAAAAAADGGGGGG
JMJJMMMJJJJMMMJMMMJJJJJJGGGGGGGGGDAAAAAAAAADGGGGGG
JJMJMMMMJMMJMJMMMJJJJJJJGGGGGGGGDAAAAAAAAAADGGGGGG
JJJJMMMMMJJJMMMMJJJJJJJGGGGGGGGGDAAAAAAAAAADGGGGGG
JJMMMMMMMMJJJJJJJJJJGGGGGGDDDGDGAAAAAAAAAAAADGGGGG
JJMMMMMMMJMJJJJJJJJJGGGGGGDAAAADAAAAAAAAAAADDDGGGD
MMMMMMMMMMMJJJJJJJJJGGGGGDDAAAAAAAAAAAAAAAADDDGDDD
JJMMMMMMMMJJJJJJJJJGGGGGDAAAAAAAAAAAAAAAAADDDDDAAA
JMMMMJMMMJJJJJJJJJJGGGGDAAAAAAAAAAAAAAAAAAAAAAAAAA
JJJMJJJJJJJJJJJJJJJGGGGDAAAAAAAAAAAAAAAAAAAAAAAAAA
JJJJJJJJJJJJJJJJJJJGGGGDAAAAAAAAAAAAAAAAAAAAAAAAAA
JJJJJJJJJJJJJJJJJJGGGGGDAAAAAAAAAAAAAAAAAAAAAAAAAA
JJJJJJJJJJJJJJJGGGGGGGDAAAAAAAAAAAAAAAAAAAAAAAAAAA
JJJJJGJJJJJJJGGGGGGGDDAAAAAAAAAAAAAAAAAAAAAAAAAAAA
JJJJGGGGJJJJJGGGDGDDAAAAAAAAAAAAAAAAAAAAAAAAAAAAAA
GGJGGGGJJJJGGGGDDDDDAAAAAAAAAAAAAAAAAAAAAAAAAAAAAA
GGGGGGGGJJGGGGGGAAAAAAAAAAAAAAAAAAAAAAAAAAAAAAAAAA
GGGGGGGGGGGGDDDAAAAAAAAADAAAAAAAAAAAAAAAAAAAAAAAAA
GGGGGGGGGGGGDAAAAAAAAAADDDDDDDDDAAAAAAAAAAAAAAAAAA
GGGGGGGDDGGDAAAAAAAAAAADDGGGDDDDAAAAAAAAAAAAAAAAAA
GGGGGDDDDGDAAAAAAAAAAAADDDDDDDDAAAAAAAAAAAAAAAAAAA
GGGGGDDDDDDAAAAAAAAAAADGGDDDDDDDAAAAAAAAAAAAAAAAAD
JJJGGGDDADDAADAAAAAAADGDDAADADDDDDAAAAAAAAAAAAAADG
JJGGGDDDAAADDAAAAAADGGGDAAAAAADDDAAAAAAAAAAAAAAAGG
JJGGGGDAAAADAAADAADGGGGDAAAAAAADDAADDAAAAAAAAAADGG
JGGGGGGDAAAAADAAAADGGGGDAAAAAAADDDDGDDAADDAAAADGGG
JJGGGGGDAADADDAAADGGGDDDAAAAAAADGGGGGGDGGGDDADDGGG
JJJGGGGGDGGDDDDAAADDDDDAAAAAAAADDGGGGGGGGGGDDGGGGG
JJJJGGGGGGGGGGDDAAAAAAAAAAAAAAAADGGGGGGGGGGGDGGGJJ
JJJJGGGGGGGGGGGDAAAAAAAAAAAAAAAADGGGGGGGGGGGGGGGJJ
JJJGGGGGGGGGGGGGDDDAAAAAAAAAAAAADGGGGGGJJGGGGGGGJJ
JJJJGGGGGGGGGGGGGDDAAAAAAAAAAAADGGGGJJJJJJGGGGGGJJ
JJGGGGGGGGGGGGGGDDDAAAAAAAAAAAADGGGGJJJJJJGGGGJJJJ
JJJGGGGGGGGGGGGDDDAAAAAAAAAAAADGGGGGJJJJJJJJJJJJJJ
JJGJJJJGGGGGGGDDDDAAAAAAAAAAADDGGGGGGJJJJJJJJJJJJJ
JJJJJJJJGGGGGDAADAAAAAAAAADDGGGGGGJGGGJJJJJJJJJJJJ
JJJJJJJJJGGGGDAAAAAAAAAAADGGGGGGGJJJGGGGJJJJJJJJJJ
JJJJJJJJJJGGGGDAAAAAAAAADDGGGGGGGGJGGGGGJJJJJJJJJJ
JJJJJJJJJJJGGGDAAAAAAAAADDDGGGGGGGGGGGGJJJJJJJJJJJ
JJJJJJJJJJGGGGGDAAAAAAAADDGGGGGGGGGGGGGJJJJJJJJJJJ
JJJJJJJJJJGGGGGAAAAAAAAAADGGGGGGGGGGGGGJJJJJJJJJJJ
JJJJJJJJJGGGGGGDAAAAAAAAADDGGGGGGGGGGGGJJJJJJJJJJJ
JJJJJJJJJGGGGGGDDAAAAAAAAADGGGGGGGGGGGGJJJJJJJJJJJ
