JJJJJJJJJJJJJJJJJJJJJJJJJJJJGGGDDDDDDDAAAAAAADDDDD
MMJJJJJJJJJJJJJJJJJJJJJJJJJJGGGDDDDDDAAAAAAAADDAAD
PMJMJJJJJJJJJJJJJJJJJJJJJJGGGGGGDDDDADDDAADDDAAAAD
MMMMMJMJJJJJJJJJJJJJJJJJGJJGGGGGGGDDDAAAAAAAAAAAAA
PMMMMMMMMMJJJJJJJJJJJJJJGJJGGGGGGGGDDAAAAAAAAAAAAA
PPPMPJMMMMMJJJJJJMJJJJJGGJJGGGGGGGGGDAAAAAAAAAAAAA
PPPPPMPPPMMMJJJJMMMJJJJJGGJGGGGGGGDAAAAAAAAAAAAAAA
PPPPPPMMMMMMMMMMJMMJJJJJJGGGGGGGGDAAAAAAAAAAAAAAAA
PPPPMPPPPPMMMMMMMMMMJJJJJJJJJGGGDAAAAAAAAAAAAAAAAA
PPMPPPPPPMMMMMMMMJJJMJJJJJJJJGGGGAAAAAAAAAAAAAAAAA
PPPPPPPMMMMMMMMMMMJJJJJJJJJJJJGGGAAAAAAAAAAAAAAAAA
PPPPPPMMMMMMMMMMJJJJJJJJJJJJJGGGDAAAAAAAAAAAAAAAAA
PPMPPPMMMMMMMMMMJMMJJMJJJJJJJGGGDAAAAAAAAAAAAAAAAA
PMPPPPPMMJMMPPPMMMMJJJJJJJJJJGGGGDDAAAAAAAAAAAAAAA
MMPPPPPPPJMMMMMMMMMJJJJJJJJJJGGGGGDAAAAAAAAAAAAAAA
MMMPPPPPMMJMMMMMMMJJJMJJJJJJJJGGGGGDAAAAAAAAAAAAAA
PMMPPMPMJMMMMMMMMMMMMMMMJJJJJJJGGGGGDAAAAAAAAAAAAA
PPPPMMJJMJMMMJMMMMMMMMMMMJJJJJGGGGGGGDAAAAAAAAAAAA
PMMPMMMMJJJJJJMJJMMMMMMMMMJJJJJGGGGGGGDAAAAAAAAAAA
PMMMMJJJJJJJJJJJJJJMMMMMMMMJJJJJJJGGGGDDAAAAAAAAAA
PMJMJJJJJJJJJJJJJJJMJMMMMMMJJJJJJJGGGGGDDDAAAAAAAA
MMMJJGJJJJJJJJJJJJJJJMMMJJJJJJJJJJGGGGGGDDAAAAAAAA
MMJJJGJJJJJJJJJJJJJJJJMJJJJJJJJJJJJGGGGGGDDAAAAAAA
JJJJJJJJJJJJJJJJJJJJJJJJJJJJJJJJJJJJGGGGDDDDAAAAAA
MMJJJJGJJJJJJJJJJJJJJJJJJJJJJJJJJJJJGGGGDADADAAAAA
JJJJJJJJJJJJJJJJJJJJJJJJJJJJJJJJJJJGGGGGDAAAAAAAAA
JJJJJJJJJJJJJJJJJJJJJJJMJJJJJGGJGJJGGGGDAAAAAAAAAA
JJJJJJJJJJJJJJJJJJJJJJJJJJJJGGGGGGGGGGGAAAAAAAAAAA
JJJJJJJJJJJJJJJJJJJJJJJJJJJJGGGGGGGGGGGDAAAAAAAAAA
JJJJJJJJJJJJJJJJJJJJJJJJJJJGGGGGGGGGGGDAAAAAAAAAAA
JJJJJJJJJJJJJJJJJJJJJJJJJGGGGGGGGGGGGGDAAAAAAAAAAA
JJJJJJJJJJJJJJJJJJJJJJJJJGGGGGGGGGGGGDAAAAAAAAAAAA
JJJJJJJJJJJJJJJJJJJJJJJJJGGGGGGGDDDDDDAAAAAAAAAAAA
JJJJJJJJJJJJJJJJJJJJJJJJJGGGGGGDDDDDDAAAAAAAAAAAAA
JJJJJJJJJJJJJJJJJJJJJJJJJGGGGGGGGGGDDDDDAAAAAAAAAA
JJJJJJJJJJJJJJJJJJJJJJJJJGGGGGGGGGGGGGDDAAAAAADDDA
JJJJJJJJJJJJJJJJJJJJJJJJJGGGGGGGGGGGGGGGAAAADDGGGD
JJJJJJJJJJJJJJJJJJJJJJJJJJGGGGGGGGGGGGGGDAADGDGGGG
JJJJJJJJJJJJJJJJJJJJJJJJJJGGGGGGGGGGGGGGGDDGGGGGGG
JJJJJJJJJJJJJJMJJJJJJJJJJJGGGGGGGGGGGGGGGGGGGGGGGG
JJJJJJJJJJJJJJJJJJJJJJJJGGGGGGGGGGGGGGGGGGGGGGGGGG
JJJJJJJJJJJJJJJJJJJJJJJJGGGGGGGGGGGGGGGGGGGGGGGGGG
JJJJJJJJJJJJJJJJJJJJJJJGGGGGGGGGGGGGGGGGGGGGGGGGGG
JJJJJJJJJJJJJJJJJJJJJJJGGGGGGGGGGGGGGGGGGGGGGGGGGG
JJJJJJJJJJJJJJJJJJJJJJJJGGGGGGGGGGGGGGGGGGGGGGGGGG
JJJJJJJJJJJJJJJJJJJJJJJJGGGGGGGGGGGGGGGGGGGGGGGGGG
JJJJJJJJJJJJJJJJJJJJJJJJJGGGGGGGGGGGGGGGGGGGGGGGJJ
JJJJJJJJJJJJJJJJJJJJJJJJJGGGGGGGGGGGGGGGGGGGGGJJJJ
JJJJJJJJJJJJJJJJJJJJJJJJJJGGGGGGGGGGGGGGGGGGGJJJJJ
JJJJJJJJJJJJJJJJJJJJJJJJJJGGGGGGGGGGGGGGGGGGJJJJJJ
