PPPMMMMMMJJJJJJJJJJJJJJGGGGDDDDDDDDADDGGGGDGGGGGGG
MPPMMMMMMJJJJJJJJJJJJJJGGGGDDDDDDDDAAADDGDAADGGGGG
MMMMMMMMMJJJJJJJJJJJJJJJGGGDDDDDADAAAAAAAAAAADGDDG
MMMMMMMMJJJJJJJJJJJJJJGGGGGGGDAAAAAAAAAAAAAADGGDDG
MMJMMMMMMJJJJJJJJJJJJJJGGGGGGDAAAAAAAAAAAAAAADDDDD
MMJMMMMMMJJJJJJJJJJJJJJJGGGGGGAAAAAAAAAAAAAADDDDDD
MMJMMJJJJJJJJJJJJJJJJJJJJGGGGGAAAAAAAAAAAAADDGGGDD
PMJJJJJJJJJJJJJJJJJJJJJJGGGGGGDDAAAAAAAAADDGGGGGGD
MJJJJJJJJJJJJJJJJJJJJJJJGGGGGGDDAAAAAAAAAADDGGGDDD
MMMMJJJJJJJJJJJJJJJJJJJGGGGGGGDDAAAAAAAAAAADDDDDDD
MJJJJJJJJJJJJJJJJJJJJJJGGGGGGDDDAAAAAAAAAAADDDDDDD
MMJJJJJJJJJJJJJJJJJJJJGGGGGGDDDDAAAAAAAAAAADDDDDDD
MJJMMJJJJJJJJJJJJJJJJJGGGGGDADDAAAAAAAAAAAADDDDDDD
MJMMMMJJJJJJJJJJJJJJJJGGGGGAAAAAAAAAAAAAAAAADDDDDD
MMMMMMMMJJJJJJJJJJJJJGGGGDDAAAAADDDDAAAAAAAADDDGDD
MMMMMJJJJJJJJJJJJJJJJGGGDAAAAAAAADAAAAAAAADADDGDDG
MMMMMMJJJJJJJJGGJJJJGGGDDAAAAAAAAAAAAAAAAADADDDDDG
MMMMJMJJJJJJGGGGJJJJJGGDAAAAAAAAAAAAAAAAAADDAAADDG
MMMMMMJJJJJJJGJGGJJJGGGDAAAAAAAAAAAAAAAAAAADAAADDG
MMMJJMJJJJJJJGGGJGGGGGGDAAAAAAAAAAAAAAAAAAAAAAADDD
MMJJJJJJJJJGGGGGGGGGGGGDAAAAAAAAAAAAAAAAAAAAAAAADD
JJJJJJJJJJJGGGGGGGGGGGGAAAAAAAAAADDDDAAAAAAAAAAADD
JJJJJJJJJGGGGGGGGGGGGGGDDAAAAAAAADGGGDAAAAAAAAAAAD
JJJJJJJJGGGGGGGGGGGGGGGDGGDADDDDDDGGGDDAAAAAADDAAD
JJJJJJJGGGGGGGGGGGGGGGGGGGGDDDGGGDGGGGDAAAADDDAAAA
JJJGGGGGGGGGGGGGGGGGGGGGGGGGGGGGGGDGGDDAADDDDDAAAA
JJJGGGGGGGGGGGGGGGGGGGGGGGGGGGGGGGGGGDAAAAAAAAAAAA
JJJJJGGGGGGGGGGGGGGGGGGGGGGGGGGGGGGDDDAAAAAAAAAAAA
JJJJJGGGGGGGGGGGGGGGGGGGGGGGGGGGGGGDDAAAAAAAAAAAAA
JJMJJGGGGGGGGGGGGGGGGGGGGGGGGGGGGGGDDAAAAAAAAAAAAA
MJJJJGGGGGGGGGGGGGGGGGGGGGGGGGGGGGGDDAAAAAAAAAAAAA
MJJJJGGGGGGGGGGGGGGGGGGGGGGGGGGGGGDDAAAAAAAAAAAAAA
MMJJJJJGGGGGGGGGGGGGGGGGGGGGGGGGGDDAAAAAAAAAAAAAAA
JMMJJJJGGGGGGGGGGGGGGGGGGGGGGGGGDDAAAAAAAAAAAAAAAA
JMMJJJJJGGGGGGGGGGGGGGGGGGGGGDDDDDAAAAAAAAAAAAAAAA
JMJJJJJGGGGGGGGGGGGGGGGGGGDDDDDDAAAAAAAAAAAAAAAAAA
MJJJJJGGGJJGGGGGGGGGGGGGGGDDDDAAAAAAAAAAAAAAAAAAAA
JJJJJJGJJJJJJGGGGGGGGGGGGGGDDDAAAAAAAAAAAAAAAAAAAA
JJJJJJGJJJJJJJJGGGGGGGGGGGGDDDAAAAAAAAAAAAAAAAAAAA
JJJJJGGJJJJJJJJGGGGGGGGGGGGDDDAAAAAAAAAAAAAAAAAAAA
JJJGGGGJJJJJJJJJJJJGGGGGGGGGDDAAAAAAAAAAAAAAAAAAAA
JGGGGGGGJJJJJJJJJJGGGGGGGGGGGDAAAAAAAAAAAAAAAAAAAA
JJGGGGGGGGJJGGGGGGGGGGGGGGGDDAAAAAAAAAAAAAAAAAAAAA
JGGGGJJJGGGJGGGGGGGGGGGGGGDDAAAAAAAAAAAAAAAAAAAAAA
JGGJJJJJGGGGGGGGGGGGGGGGGDDAAAAAAAAAAAAAAAAAAAAAAA
JJJJJJJJGGGGGGGGGGGGGGGGGDDAAAAAAAAAAAAAAAAAAAAAAA
JJJJJJGGGGGGGGGGGGGGGGGGGGDAAAAAAAAAAAAAAAAAAAAAAA
JJJJJJGGGGGJJJGGGGGGGDGGGDDAAAAAAAAAAAAAAAAAAAAAAA
JJJJJJGGJJJJJJJGGGGDDDDDDDAAAAAAAAAAAAAAAAAAAAAAAA
JJJJJJGJJJJJJJJGGGGDAAAAAAAAAAAAAAAAAAAAAAAAAAAAAA
