AAAAAAAAAAAAAAAAAAAAADGGDGGGGGGGGGGGGGGGJJJJJJJJJJ
AAAAAAAAAAAAAAAAAAAAAAADADGGGGGGGGGGGGGGJJJJJJJJJJ
AAAAAAAAAAAAAAAAAAAAAAAAADDGDGGDDGGGGGGGGGGJJJJJJJ
AAAAAAAAAAAAAAAAAAAAAAAAADAAADDDDGDGGGGGJJJJJJJJJJ
AAAAAAAAAAAAAAAAAAAAAAAAAAAAAAAAADGGGGGGGGJJJJJJJJ
AAAAAAAAAAAAAAAAAAAAAAAAAAAAAAAAAADGGGGGGGGJJJJJJJ
AAAAAAAAAAAAAAAAAAAAAAAAAAAAAAAAAADGGGGGJJJJJJJJJJ
AAAAAAAAAAAAAAAAAAAAAAAAAAAAAAADDDDDGGGGJJJJJJJJMJ
AAAAAAAAAAAAAAAAAAAAAAAAAADAAADGGGGGGGGGJJJJJJJJJJ
AAAAAAAAAAAAAAAAAAAAAAAAAAAAADGGGGGGGGGJJJJJJJJJJJ
AAAAAAAAAAAAAAAAAAAAAAAAAADDDGGGGGGGGGJJJJJJJJJJJJ
AAAAAAAAAAAAAAAAAAAAAAAAADDDGGGGGGGGGJJJJJJJJJJJJJ
AAAAAAAAAAAAAAAAAADDDDDDDDDGGGGGGJJJJJJJJJJJJJJJJJ
AAAAAAAAAAAAAAAADGGGGGGGGGGGGGGGGJJJJJJJJJJJJJJJJJ
AAAAAAAAAAAAAAADGGGGGGGGGGGGGGGGJJJJJJJJJJJJJJJJJJ
AAAAAAAAAAAAAAADGGGGGGGGGGGGGJJJJJJJJJJJJJJJJJJMMJ
AAAAAAAAAAAAAAADGGGGGGGGGGGGJJJJJJJJJJJJJJJJJJJMMJ
AAAAAAAAAAAAAAADGGGGGGGGGGGJJJJJJJJJJJJJJJJJJJJMMJ
AAAAAAAAAAAAAAADGGGGGGGJJGJJJJJJJJJJJJJJJJJJJJMMMJ
AAAAAAAAAAAAAAADGGGGGGGJJJJJJJJJJJJJJJJJJJJJJMMMMM
AAAAAAAAAAAAAAADGGGGGGGJJJJJJJJJJJJJJJJJJJJJJJMMMM
AAAAAAAAAAAAAAAGGGGJJJJJJJJJJJJJJJJJJJJJJJJJJMMMMM
AAAAAAAAAAAAAADGGGGJJJJJJJJJJJJJJJJJJJJJJJJJMMMMMM
AAAAAAAAAAAAAADGGGJJJJJJJJJJJJJJJJJJJJJJJJJJJMMMMM
AAAAAAAAAAAAAADGGGGJJJJJJJJJJJJJJJJJJJJJJJJJJMJMJM
AAAAAAAAAAAAAADGGGGGJJJJJJJJJJJJJJJJJJJJJJJJJMMMJM
AAAAAAAAAAAAAADGGGGGJJJJJJJJJJJJJJJJJJJJJJJJJJJJJM
AAAAAAAAAAAAAADGGGGJJJJJJJJJJJJJJJMMMJJJJJJJJMJJJM
AAAAAAAAAAAAAADGGGGJJJJJJJJJJJJMMJJJMJJJJJJJJJJJJJ
AAAAAAAAAAAAADGGGGGJJJJJJJJJJJJMMMMJMJJJJJJJJJJMMM
AAAAAAAAAAAAAGGGGGGJJJJJJJJJJJJMMMMMJJJJJJJJJJJMMM
AAAAAAAAAAAAAGGGGGGJJJJJJJJJJJJMMMMMMJJJJJJJMJJMMM
AAAAAAAAAAAADGGGGGGJJJJJJJJJJJJMMMMMMJJJJJJJJJJJMM
AAAAAAAAAAAADGGGGGJJJJJJJJJJJJJJMMMMMMMJJJMJJJJJMM
DDDDAAAAAAAADGGGGJJJJJJJJJJJJJJJMJMJJJJJJMJJJJJJJM
GGGGGDAAAAAADGGGJJJJJJJJJJGGJJJJJJJMJJJJMMMJJJMJJM
GGGGGGDAAADDGGGJJJJJJJJJJGGGGJJJJJJMMJJMJMMJJJJJMM
GGGGGGGADADGGGGJJJJJJJJGGGGGGJJJJJMMMJMMMMMMJJMJMM
GGGGGGGDDDGGGGJJJJJJJJGGGGGGGGJJJMMMMMMMPPPPMMPMMM
GGJGGGGGGGGGGGJJJJJGGGGGGGGGGGJJJJMMMMMPPMMMMMMJMP
GGGGGGGGGGGGGGJJJJJGGGJGGGGGGJJJJMMMMMPPPMPMMMMMJM
GGGGGGGGGGGGGGGJJGGGGJJJJJGGJJJJJJMMMPPPPMMPMMJJMM
GGGGGGGGGGGGGGJGGGGGGJJJJJJJJJJJJMMPPPPPPPPMPMJPMM
GGGGGGGGGGGGGGGGGGGGGGJJJJJJJJJJJJMMMPPPPPPMMMJMPM
GGGGGGGGGGGGGGGGGGGGGGJJJJJJJJJJJJMPPPPPMPPPMJMMPP
GGGGGGGGGGGGGGGGGGGJJGJJJJJJJJJJMMMMPPPPPMPPMJMMPP
GGGGGGGGGGGGGGGGGGJJJJJJJJJJJJJJJJJMMMMMPPPPPMPPPP
GGGGGGGGGGGGGGGGGGJJJJJJJJMMMJJJJJJMJJMPPPMMMPPPPP
GGGGGGGGGGGGGGGGGJJJJJJJJMJJJJJJJJJJJMMMMPPPPPPPPP
GGGGGGGGGGGGGGGGGJJJJJJJJJJMJJJJJJJMMMMMPPPPMPPPPP
