JJJJJJJJJJJJJJJJJJJJMMPMMMJJMMPPPPPPPPPPPPPPPPMMPP
JJJJJJJJJJJJMMJJJMJJMMMMJJMJMMPPPPPPPPPPPPPPPPMMPP
JJJJJJJJMJJMMMJJMMMMMMMJJJMJMPPPPPPPPPPPPPPPPPPMPP
JJJJJJJJMMMMMMMMMMMMMMJJJMMJMMMPPMPPPPPPPPPPPPMMMP
JJJJJJJMMMMMJMMMMMMMMMJJJJJMMMMPPPPMPPPPPPPPPPPMMJ
JJJJJJJMMMMJJJJMMMMMPMJMJJJJMMMMMMPPPPPPPPPPPPPMJM
JJJJJJJJMMMJMJJJMMMMPMMMMJJMMMMMMMMPMPPPPPPPPPPMJM
JJGJJJJJJJJJJJJJMMMMPMMMJMJMMMMMMJMPPPPPPPPMPMMMMM
JGGGJJJJJJJJJJJJMJMMMMPMMJMMMMJMMMMMPPPPPPPPPMMMMM
GGGGGGJJJJJJJJJJJMMMMPMMMMJJJJJMMMPMPPPPPMPPMMMMMJ
GGGGGGGGJJGGJJGJJJJMMMPMMMJMJMMMJMMMMPPPMPPMMMMJJJ
JGGGGGGGGGGGGGJJJJJMMMMMMMMJJJJMJMJMMPMPPMMMMMJJJJ
JJGGGGGGGGGGGGJJJJJJMMMMMMMMJJJJMJJMMMPPPMMMJJJJJJ
GGGGGGGGGGGGGGGJJJJJMMMMMMMMMJMMMMJMMPPPMMMMJJJJJJ
GGGGGGGGGGGGGGGJJJJJMMMJMMJJJJMMMMMMMMMMMMMMJJJJJJ
GGGGGDGGGGGGGGGJJJJJMJMJJJJJJJMMMMMMMMMMMJJJJJJJJJ
GGGGDDDDDGGGGGJJJJJJJJJJJJJJJJJJMMMMMMMMMJJJJJJJJJ
GGGGDDDDDGGGGGJJJJJJJJJJJJJJJJJJJJMMMMMMJJJJJJJJJJ
GGGGDDDDDGGGGGGJJJJJJJJJJJJJJJJJJJJJJMMMMJJJJJJJJJ
GGGGGDDDDDDGGGGJGJJJJJJJJJJJJJJJJJJJJJMMMMJJJJJJJJ
GGGGDDDDDDDGGGGGGJJJGGJJJJJJJJJJJJJJJMMMMMJJJJJJJJ
GGGGDDDDDDDGGGGGGGGGGGGJJJJJJJJJJJJMMMMMMMJJJJJJJJ
GGGGDDDDDDDGGGGGGGGGGGGGGJJJJJJJJJJMMMMMMJJJJJJJJJ
GGGDDADADDDDGGGGGGGGGGGGGJGGGJJJJJJJMMMMMJJJJJJJJJ
GGGDAAAADGGGGGGGGGGGGGGGGGGGGGJJJJJMJJJJJJJJJJJJJJ
DGDAAAAADGGGGGGDGGGGGGGGGGGGGGGJJJJJJJJJJJJJJJJJJJ
DDAAAAADGGGGGGDDDGGGGGDDGGGGGJJJJJJJJJJJJJJJJJJJJJ
ADDDDDADDDGDDDDDDDGGGDDDGGGGGJJJJJJJJJJJJJJJJJJJJJ
ADDDAADAAGDDAAAAADDADDDDGGGGGGJJJJJJJJJJJJJJJJJJJJ
AADAAADADDDDAAAADAAADADGGGGGGGJJJJJJJJJJJJJJJJGGGG
AAAAAAAADDDAAAAADAAADADDDGGGGGGGGGGGJJGGGGGGGGGGGG
AAAAAAAADDAAAAAAAAAAADDDGDGGGGGGGGGGGGGGGGGGGGGGGG
AAAAAAAAAAAAAAAAAAAAADDDDDGGGGGGGGGGGGGGGGGGGGGGGG
AAAAAAAAAADDAAAAAAAAAAAAAADDGGGGGDDADGGGDGGGGGGGGG
AAAAAAAAAADAAAAAAAAAAAAAAADDGGGGDAAAAAAADDGGGGGGGG
AAAAAAAAAAAAAAAAAAAAAAAAAADDDGGDDAAAAAAAAADDDDGGGG
AAAAAAAAAAAAAAAAAAAAAAAAAADDDDAAAAAAAAAAAAAAADDDDG
DAAAAAAAAAAAAAAAAAAAAAAAAADDDAAAAAAAAAAAAAAAADDDDD
DDDDAAAAAAAAAAAAAAAAAAAAADDDAAAAAAAAAAAAAAAAADDDDG
DDDDAAAAAAAAAAAAAAAAAAAAAAAAAAAAAAAAAAAAAAAAADDDGG
AADDAAAAAAAAAAAAAAAAAAAAAAAAAAAAAAAAAAAAAAAADDGGGG
AADDAAAAAAADDDDDDAAAAAAAAAAAAAAAAAAAAAAAAAAADGGGGG
AADDDDAAAAADGGGDDAAAAAAAAAAAAAAAAAAAAAAAAAAADGGGGG
AADDDDDAAADGGGGGDAAAAAAAAAAAAAAAAAAAAAAAAAAADDGGGG
AADDDDDAAADGGGGGGDAAAAAAAAAAAAAAAAAAAAAAAAAADDDGGG
ADDDADAAADDGGGGGGDAAAAAAAAAAAAAAAAAAAAAAAAAAAADDGG
ADDDAADAADDGGGGGGDAAAAAAAAAAADAAAAAAAAAAAAAAAAADDD
AAAAAAAADDDGGGGGGDAAAAAAAAAAADDAAAAAAAAAAAAAAAAAAA
AAAAADDDGGGGGGGGGGDAAAAAAAAADAAAAADAAAAAAAAAAAAADA
AAAAAADGGGGGGGGGGDDAAAAAAAAAAAAAADDAAAAADAAAAAAAGD
