MMMMJJJJJJJJJJMMJJJJJJJJJGJJGGGGDAAAAAAAAAAAAAADGG
MMMJJMJJJJJJJJJJJJJJJGGGGJGJGGGDAAAAAAAAAAAAAAAAGG
JJJJMJMJJMJJJMMJJJJJJJGGGGGGGGDAAAAAAAAAAAAAAAAADG
JJJJJJMMMMJMMMMMJJJJJGGGGGGGGGDAAAAAAAAAAAAAAAAAAD
JJJJJMMMMJJMMMMMMJJJJGGGGGGGGGDAAAAAAAAAAAAAAAAAAD
JJJJJJJMJJJJJJMMMJJJJJGGGGGGGGDAAAAAAAAAAAAAAAAAAA
JJJJJJJJJJJJJJMMJJJJJJGGGGGGGGDAAAAAAAAAAAAAAAAAAA
JJJMJJJJJJJJJJJJJJJJJGGGGGGGGGDAAAAAAAAAAAAAAAAAAA
JJJMJJJJJJJJJJJJJJJJJGGGGGGGGGGAAAAAAAAAAAAAAAAAAA
JJJMMJJJJJJJJJJJJJJJJGGGGGGGGGGAAAAAAAAAAAAAAAAAAA
JJMMMJJJJJJJJJJJJJJJJGGGGGGGGGGAAAAAAAAAAAAAAAAAAA
JJJJJJJJJJJJJJJJJJJJJGGGGGGGGGDAAAAAAAAAAAAAAAAAAA
JJJJJJJJJJJJJJJJJJJJJJGGGGGGGGDDAAAAAAAAAAAAAAAAAA
JJJJJJJJJJJJJJJJJJJJJJGGGGGGDDDAAAAAAAAAAAAAAAAAAA
JJJJJJJJJJJJJJJJJJJJJJJGGGGGGDAAAAAAAAAAAAAAAAAAAA
JJJJJJJJJJJJJJJJJJJJJJJJGGGGDDAAAAAAAAAAAAAAAAAAAA
JJJJJJJJJJJJJJJJJJJJJJJJJJGGDDDAAAAAAAAAAAAAAAAAAA
JJJJJJJJJJJJJJJJJJJJJJJJJJGGGGDAAAAAAAAAAAAAAAAAAA
JJJJJJJJJJJJJJJJJJJJJJJJJJGGGGDAAAAAAAAAAAAAAAAAAA
JJJJJJJJJJJJJJJJJJJJJJJJJJJGGGDAAAAAAAAAAAAAAAAAAA
JJJJJJJJJJJJJJJJJJJJMMJJJJJGGGGDAAAAAAAAAAAAAAAAAA
JJJJJJJJJJJJJJJJJJJJJJJJJJJGGGGGDAAAAAAAAAAAAAAAAA
JJJJJJJJJJJJJJJJJJJJJJJJJJJGGGGGGDAAAAAAAAAAAAAAAA
JJJJJJJJJJJJJJJJJJJJJJJJJJJJGGGGGGAAAAAAAAAAAAAAAA
JJJJJJJJJJJJJJJJJJJJJJJJJJJJGGGGGGDAAAAAAAAAAAAAAA
JMMJJJJJJJJJJJJJJJJJJJJJJJGGGGGGGGGDAAAAAAAAAAAAAA
JJJMMJJJJJJJJJJJMJJJJJJJJJJGGGGGGGGGDAAAAAAAAAAAAA
JJJMMJJJJJJJJJJJJJJJJJJJJJJJGGGGGGGGGDAAAAAAAAAAAA
JJJMMMJJJJJJJJJJJMJJJJJJJJJJJJJGGGGGGGAAAAAAAAAAAA
MJMMJMMJJJJJJJJJJJJJJJJJJJJJJJJGGGGGGGGDAAAAAAAAAA
JMMJMMMJJJJJJJJJJJJJJJJJJJJJJJJGGGGGGGDDAAAAAAAAAA
MMMMMMMJJJJJJJJJJJJJJJJJJJJJJJJJGGGGGGDDDDAAAAAAAA
MMMMMMMMJJJJJJJJJJJJJJJJJJJJJJJGGGGGGDDDDDDAAAAAAA
MMMMMMMJJJJJJJJJJJJJJJJJJJJJJJJGGGGGGGGGDGGAAAAAAA
MMMJMMJJJJJJJJJJJJJJJJJJJJJJJJJGGGGGGGGGGGGDDAAAAA
MMMMJJJJJJJJJJJJJJJJJJJJJJJJJJJGGGGGGGGGGGGGDDDDDD
MMMMJJJJJJJJJJJJJJJJJJJJJJJGJJGGGGGGGGGGGGGGGGGDDD
MMMJJJMJJJJMJJJJJJJJJJJJJJJGGGJGGGGGGGGGGGGGGGGGDD
MMMMMJMMJMMJJJJJJJJJJJJJJJJGGGGJGGGGGGGGGGGGGGGGGG
PMPPMMMMMMMMJJJMJJJJJJJJJJJJGJJGGGGGGGGGGGGGGGGGGG
PPPPPPPPMMMMJJMJJJJJJJJJJJJJGGGGGGJJGGGGGGGGGGGGGG
PPPPPPMMMMMMMMMJMJJJJJJJJJJJJGJJJJJJJGGGGGGGGGGGGG
PPPPPPPPMPPMMMMMMJJMJJJJJJJJJJJJJJJJJGGGGGGGGGGGJJ
PPPPPPPPPPPMMMMJJJJMJJMMJMJJJJJJJJJJJGGGGGGGGGJJJJ
PPPPPPPPPPPPMMMMMJJMMMMMMMMJJJJJJJJJJJGGGGGGGGJJJJ
PPMPPPPPPPPMMPMMJMJMMMMMJJJJJJJJJJJJJJGGGGGJJJJJJJ
PPPPPPPPPPPMMMMMJJJMMMMJJMJJJJJJJJJJJJJGGGJJJJJJJJ
PPPPPPPPPPPMMJMJJJMMMMJJJJMJJJJJJMJJJJJJJJJJJJJJJJ
PPPPMPPPPPMMMMJMJMMMMJMJMJJJJJJJJJJJMJJJJJJJJJJJJJ
PPPPPPPPPPMPMJMMMJMMMMMMMJMMJJJJJJJJJJJJJJJJJJJJJJ
