AAAAAAAAAAAAAAAAAAAAAAAAAAAAAAGGGGGGGGGGGGGGGGJJJJ
AAAAAAAAAAAAAAAAAAAAAAAAAAAAAAAADDDGGDDGGGGGGGGJJJ
AAAAAAAAAAAAAAAAAAAAAAAAAAAAAAAAAAAADDADGGGGGGJJJJ
AAAAAAAAAAAAAAAAAAAAAAAAAAAAAAAAAAAAAADDGGGGGGJJJJ
AAAAAAAAAAAAAAAAAAAAAAAAAAAAAAAAAAAAAADDGGGGGJJJJJ
AAAAAAAAAAAAAAAAAAAAAAAAAAAAAAAAAAAAADDDGGGGGJJJJJ
AAAAAAAAAAAAAAAAAAAAAAAAAAAAAAAAAAADDGGGGGGGJJJJJJ
AAAAAAAAAAAAAAAAAAAAAAAAAAAAAAADDDDGGGGGGGGJJJJJJJ
AAAAAAAAAAAAAAAAAAAAAAAAAAAAAADGGGGGGGGGGGJJJJJJJJ
AAAAAAAAAAAAAAAAAAAAAAAAAAAAAADGGGGGGGGGJJJJJJJJJJ
AAAAAAAAAAAAAAAAAAAAAAAAAAAAADGGGGGJGGJJJJJJJJJJJJ
AAAAAAAAAAAAAAAAAAAAAAAAAAADDGGGGGGJJJJJJJJJJJJJMM
AAAAAAAAAAAAAAAAAAAAAAAAAADDGGGGGGGJJJJJJJJJJJJMMM
AAAAAAAAAAAAAAAAAAAAAAAAADDGGGGGGGGJJJJJJJJJJMMMMM
DDDDAAAAAAAAAAAAAAAAAAAADDDGGGGGGGGJJJJJJJJJMMMMMM
GGDDDAAAAAAAAAAAAAAAAAAADGGGGGGGGJJJJJJJJJJJJMMMMP
GGGGGAAAAAAAAAAAAAAAAADDDGGGGGGGGJJJJJJJJJJJJMMMMP
GGGGGGDAAAAAAAAAAAAAAADDGGGGGGGGGGGJJJJJJJJJJMMMMP
GGGGGGDDDDAAAAAAAAAAADDGGGGGGGGGGGJJJJJJJJJJJJMMMP
GGGGGGGGDAAAAAAAAAAAADDGGGGGGGGGGJJJJJJJJJJJJJMMMP
GGGGGGGDAAAAAAAAAADADDDGGGGGGGGGGGGGGGJJJJJJJJMMMP
GGGGGDDDDAAAAAAADDDDAAADGGGGGGGGGGGGGGJJJJJJJJJMMP
GGGGGGDGAAAAAADDDDDDAAADDGGGGGGGGGGGGGJJJJJJJJMMMP
GGGGGGGDAAAAADGDGGGDDDDGGGGGGGGGGGGGJGJJJJJJJJJMMP
GGGGGGGGDAADDGGGGGGGGGGGGGGGGGGGGGGJJJJJJJJJJJMMMP
GGGGGGGGGGGGGGGGGGGGGGGGGGGGGGGJJJGGGJJJJJJJJJMMPP
GGGGGGGGGGGGGGGGGGGGGGGGGJJJJGGJJGJGGJJJJJJJJJMMPP
GGGGGGGGGGGGGGGGGGGJJJGJJJJJJGGGJJGJJJJJJJJJJMMPPM
GGGGGGGGGGGGGGGGGGGJJJJJJJJJJJJJJJGGJJJJJJJJMMMMMP
GGGGGGJJGGGGGGGGGGJJJJJJJJJJJJJJJJGGGJJJJJJJMMPPPP
GGJGGGGGJJGGGGGGGGJJJJJJJJJJJJJJJJGGGJJJJJMMMMPPPP
GGJGGGGGGGGJGGGGGGJJJJJJJJJJJJJJJJJJJJJJJJMMMPMPPP
GGGJGGGGGGGGGGGGGGJJJJJJJJJJJJJJJJJJJJJJMMMMMMMPPP
GGGJGGGGGGGGGGGGGGGJJJJJJJJJJJJJJJJJJJJMMMMPMMMPPP
GGGGGGGGGGGGGGJGJGGGGJJJJJJJJJJJJJJJJJMMMMMPPMMMPP
GGGGGGGGGGGGGGGGGGGGGJJJJJJJJJJJJJJJJJMMMMMMMMMMMM
GGGGGGGGGGGGGGGGGGGGGJJJJJJJJJJJJJJJJMMMMMMMMMMMMM
GGGGGGJGGGGGGGGGGGGGGJJJJJJJJJJJJJJJMJMJJMJJJMMMMM
GGGGGJJGGGGGGGGGGGGGJJJJJJJJJJJJJJJJJMJJJMJJJMMMMM
GGGGGJJGGGGGGGGGGGGGJJJJJJJJJJJJJJJJJJJJJJJJJJMMMM
GGGGGJGGGGGGGGGGGGGJJJJJJJJJJJJJJJJJJJJJJJJJJJMMMM
GGGGGGGGGGGGGGGGGGJJJJJJJJJJJJJJJJJJJJJJJJJJJJMMMM
GGGGGGGGGGGGGGGGGGGJJJJJJJJJJJJJJJJJJJJJJJJJJJJMMM
GGGGGGGGGGGGGGGGGGJJJJJJJJJJJJJJJJJJJJJJJJJJJJJJJJ
GGGGGGGGGGGGGGGGGGGJJJJJGJJJJJJJJJJJJJJJJJJJJJJJJJ
GGGGGGGGGGGGGGGGGGGGJGGJGGJJJJJJJJJJJJJJJJJJJJJJJJ
GGGGGGGGGGGGGGGGGGGGGGGGGGJJJJJJJJJJJJJJJJJJJJJJJJ
GGGGGGGGGGGGGGGGGGGGGGGGGGJGGGJJJJJJJJJJJJJJJJJJJJ
GGGGGGGGGGGGGGGGGGGGGGGGGGGGGGGJJJJJJJJJJJJJJJJJJJ
GGGGGGGGGGGGGGGGGGGGGGGGGGGGGGGGGGJJJJJJJJJJJJJJJJ
