MJJJJJJJJJJJJJJJGGGGGGGGGGGGGGGGGDGGGGGDAAAADDDDDD
MMMMJJJJJJJJJJJJGGGGGGGGDDGGGGGGGADDDDDAAAAADDDDDD
MMMMJJMJJJJJJJJJGGGGGGGGDDGGGGGDAAAAAAAAAAAAAADDDD
PPMMJMMMMJJJJJJJJGGGGGGGDDDDDDDAAAAAAAAAAAAAAAADDD
MMMMMMMMJJJJJJJJJGGGGGGGGDDDAAAAAAAAAAAAAAAAADDDDG
MMMJJJJJJJJJJJJJJGGGGGGGGGGGDAAAAAAAAAAAAAAADDDDDG
MMJMMJJJJJJJJJJJJJGGGGGGGGGGDAAAAAAAAAAAAAAADDDDGD
MJMMJJJJJJJJJJJJJJGGGGGGGGGGAAAAAAAAAAAAAAAAAAAADD
MMMJJJJJJJJJJJJJJGGGGGGGGGGDAAAAAAAAAAAAAAAAAAAAAA
MMMJJJJJJJJJJJJJJGGGGGGGGGGGAAAAAAAAAAAAAAAAAAAAAA
MMJJJJJJJJJJJJJJJJGGGGGGGGGDAAAAAAAAAAAAAAAAAAAAAA
MMMMMMJJJJJJJJJJJJJJGGGGGGGGAAAAAAAAAAAAAAAAAAAAAA
MMMMMMJJJJJJJJJJJJJJGGGGGGDDDAAAAAAAAAAAAAAAAAAAAA
JJJJJJMJJJJJJJJJJJJJGGGGGGDDDAAAAAAAAAAAAAAAAAAAAA
JJJJJJJJJJJJJJJJJJJGGGGGGDDAAAAAAAAAAAAAAAAAAAAAAA
JJJJJJJJJJJJJJJJJJJGGGGGGDDAAAAAAAAAAAAAAAAAAAAAAA
JJJJJJJJJJJJJJJJJJGGGGGGGDAAAAAAAAAAAAAAAAAAAAAAAA
JJJJJJJJJJJJJJJJJJGGGGGGGGDAAAAAAAAAAAAAAAAAAAAAAA
JJJJJJJJJJJJJJJJJJGGGGGGGDDAAAAAAAAAAAAAAAAAAAAAAA
JJJJJJJJJJJJJJJJJJJGGGGGGGGAAAAAAAAAAAAAAAAAAAAAAA
JJJJJJJJJJJJJJMJJJJGGGGGGGGDAAAAAAAAAAAAAAAAAAAAAA
JJJJJJJJJJJJJJJJJJJJGGGGGGGDAAAAAAAAAAAAAAAAAAAAAA
JJJJJJJJJJJJJMJJJJJJJGGJGGGDAAAAAAAAAAAAAAAAAAAAAA
JJJJJJJJJJJJJJJJJJJJJJJJJGGDAAAAAAAAAAAAAAAAAAAAAA
JJJJJJJJJJJJJJJJJJJJJJJJJGGDAAAAAAAAAAAAAAAAAAAAAA
JGJJJJJJJJJJJJJJJJJJJJJJGGGGDDDAAAAAAAAAAAAAAAAAAA
JJJJJJJJJJJJJJJJJJJJJJJGGGGGGGGGDAADDAAAAAAAAAAAAA
JJJJJJJJJJJJJJJJJJJJJJJJGGGGGGGGDDDDDDAAAAAAAAAAAA
JJJJJJJJJJJJJJJJJJJJJJJJGGGGGGGGGGDGGGDAAAAAAAAAAA
JJJJJJJJJJJJJJJJJJJJGGGGGGGGGGGGGGGGGGGAAAAAAAAAAA
JJJJJJJJJJJJJJJJJJGGGGGGGGGGGGGGGGGGGGGAAAAAAAAAAA
JJJJJJJJJJJGGJJJJJGGGGGGGGGGGGGGGGGGGGGAAAAAAAAAAA
JJJJJJJJJJJJGJJJJJGGGGGGJJGJGGGGGGGGGGDAAAAAAAAAAA
JJJJJJJJJJJJJJJJGGGGGGGGJJJJJJGGGGGGGGGAAAAAAAAAAA
JJJMMJJJJJJJJJJJGGGGGGGJJJJJJJJJJGGGGGDAAAAAAAAAAA
JJJJMMMJJJJJJJGGGGGGGJJJJJJJJJJJJGGGGGGDAAAAAAAAAA
JJJJJMMJJJJJJJGJGGGGJJJJJJJJJJJJJGGGGGDDAAAAAAAAAA
JJJJJMMMJJJJJJJGGGGGJJJJJJJJJJJJJGGGGGDAAAAAAAAAAA
JJJJJMMMMJJJJJGGGGGJJJJJJJJJJJJJJGGGGGGDDAAAAAAAAA
JJMMMMMMMJJJJJJGGGJJJJJJJJJJJJJJJJGGGGGGDAAAAAAAAA
JJJMMMMJMJJJJJJGGGJJJJJJJJJJJJJJJJJJGGGGDAAAAAAAAD
JJJJMMMMMJJJJJJGGGJJJJJJJJJJJJJJJJJJGGGGGDAAAADDDD
JJMMMMMMMMJJJJJJJJJJJJJJJJJJJJJJJJJGGGGGGDDDDDDGGG
JMMMMMMMMMMJJJJJJJJJJJJJJJJJJJJJGGGGGGGGGGGDDGGGGG
JMJJMMMMMMJJJJJJJJJJJJJJMMMJJJJJGGGGGGGGGGGGGGGGGG
JJMMMMMMJMJJJJJJJJJJJJJMMMMMJJJGGGGGGGGGGGGGGGGGGG
JMJJMMMJJMMJJJJJJJJJJJJMMMMMJJJGGGGGJJGGGGGGGGGGGG
JJJJJJJJMMMMJJJJJJJJJMMMMMJJJJJGGGGGJJGGGGGGGGGGGG
MJJJMMJMMMMMMMJJJJJJJMMMMMJJJJJJJJGJJJGGGGGGGGGGGG
MJMMMMMMMMMMMMJJJJJJJJMJMMJJJJJJJJJJJGGGGGGGGGGGGG
