AAAAAAAAAAAAAAAAADDDDGGGGDAAAAAADDGGGGGJJJJJJJJJJJ
AAAAAAAAAAAAAAAAADDDDDDGDAAAAAAAADGGGGJJJJJJJJJJJJ
AAAAAAAAAAAAAAAAADDDAAADDAAAAAAAADDGGGGJJJJJJJJJJJ
AAAAAAAAAAAAAAAAADDDAAAAAAAAAAAAAAAADGGGJJJJJJJJJJ
AAAAAAAAAAAAAAAAADDDAAAAAAAAAAAAAAAAAGGGGGGJJJJJJJ
AAAAAAAAAAAAAAAADDDAAAAAAAAAAAAAAAAAADGGGGGGJJJJJJ
AAAAAAAAAAAAAAAADDDAAAAAAAAAAAAAAAAAADGGGGJJJJJJJJ
AAAAAAAAAAAAAAAADDAAAAAAAAAAAAAAAAAAAGGGGGGGJJJJJJ
AAAAAAAAAAAAAAAAAAAAAAAAAAAAAAAAAAAAADGGGGGJJJJJJJ
AAAAAAAAAAAAAAAAAAAAAAAAAAAAAAAAAAAAADGGGGJJJJJJJJ
AAAAAAAAAAAAAAAAAAAAAAAAAAAAAAAAAAAADDGGGGGJJJJJJJ
AAAAAAAAAAAAAAAAAAAAAAAAAAAAAAAAAAADDDGGGGJJJJJJJJ
AAAAAAAAAAAAAAAAAAAAAAAAAAAAAAAAAAADGGGGGJJJJJJJJJ
AAAAAAAAAAAAAAAAAAAAAAAAAAAAAAAAADDDGGGGGGJJJJJJJJ
AAAAAAAAAAAAAAAAAAAAAAAADDDAAAAAADGGGGJJJJJJJJJJJJ
AAAAAAAAAAAAAAAAAAAAAAADDGGGGGDAGGGGJJJJJJJJJJJJJJ
AAAAAAAAAAAAAAAAAAAAAAADGGGGGGGGGGGJJJJJJJJMJJJJJJ
AAAAAAAAAAAAAAAAADAAAAAGGGGGGGGGGGJJJJJJJJMMJJJJJJ
AAAAAAAAAAAAAAAAADAAADGGGGGGGGGGGGJJJJJJMMMMMMJJJJ
AAAAAAAAAAAAAAAADDDDGGGGGGGGJJJJJJJJJJMMMMMMMMJMJM
AAAAAAAAAAAAAAADGDDGGGGGGGGGJJJJJJJJJMMMMMMMMMMMMM
AAAAAAAAAAAAADDGGGGGGGGGGGGGJJJJJJJJJJJMMMMMMMMMMJ
AAAAAAAAAAAADGGGGGGGGGGGGGJGJJJJJJJJJJJJMMMMMMJMMM
AAAAAAAAAAAAGGGGGGGGGGGGJJJJJJJJJJJJJJJJMMMMMMJMJJ
AAAAAAAAAAAAGGGGGGGGGGGJJJJJJJJJJJJJJJJJMMMMMJJJJJ
AAAAAAAAADDDDGGGGGGGGGJJJJJJJJJJJJJJJJJJJMMMMJJJJJ
AAAAAAAADDDDDGGGGGGGGJJJJJJJJJJJJJJJJJJJMJJMMMJJJJ
AAAAAAAAAADDDGGGGGGGGJJJJJJJJJJJMMMJJJJJMMMMMMMMJJ
AAAAAAADAADDGGGGGGGGGJJJJJJJJJJJMMMJMJJMMMMMMMMMJJ
AAAAAAAAADDDGGGGGGGGGJJJJJJJJMMMMMMMMJJJMMMMMMMJJJ
AAAAAAAAADDGGGGGGGGGGJJJJJJJJMMMMPMMMMMMMMMMMMMMMJ
AAAAAAAAGDDGGGGGGGGGJJJJJJJJMMMMPPPPPMPMMMMMMMMMMJ
AAAAAAADGGGGGGGGGGJJJJJJJJJMMMMMPPPPPPMPMMMMMPMMJJ
DDDDDDGGGGGGGGGGGGGJJJJJJJJJMMMPPPPPPPPPPMMMMMMMJJ
GGGGGGGGGGGGGGGGGGGJJJJJJJJJMMMPPPPPMMPPPPMMJMJJMJ
GGGGGGGGGGGGGGJJGGJJJJJJJJJMMMPPPMPMMMMMMMMMMMMJJJ
GGGGGGGGGGGGGGJJJJJJJJJJJJJMMMPPPPMMMMMPMMMMMMMJJJ
GGGGGGGGGGGGGGGJJJJJJJJJJJJMMMMMPMMMMMMMMMMMJMMJJJ
GGGGGGGGGGGGGJJGGJJJJJJJJMMMMMMMMMMMMMMMMMMJMMMJJJ
JJGGGGGGGGGJJJJJJJJJJJJJJJJMMMMMMMMMMMMMMMJMMJMMMJ
JJJJGGGGGGJJJJJJJJJJJJJJJJJMMMMMMMMMPMPPMPMMMMMMMM
JJJJJGGGJJJJJJJJJJJJJJJJJJMMPPPPPPMMPPPMMMPMMMPMJM
JJJJJJGGJJJJJJJJJJJJJJJJJJMPPPPPPPMPMPPPPPPPMMMMMM
GJJJJJJJGGJJJJJJJJJJJJJMMMMMMPPMMPMMMPMPPPPPMMMMMM
GJJJJGGGGJJJJJJJJJJJJJJJMMMMMMPMPPMMPMPPPPPPPPPMMM
GJJGGGGGGGJJJJJJJJJJJJJJMMMJMMPPPPMMMMPPPPPPPPMPMM
GJJGGGGGGJJJJJJJJJJJJJJJJJMMMMMMMPMMMPPPPPPPMMMMMM
GJJJGGGGGGJJJJJJJJJJJJJJJJJJMJMMMMMMMMPPPMMMMMMMMM
GGJJGGGGGGGJJJJJJJJJJJJJJJJJJJMMMJMMPPMMMMMMJMMJMJ
GGGGGGGGGGJJJJJJJJJJJJJJJJJJMJMMMMMMMMMPMPMMJJJJJJ
