JJJJJJJJJJJGGGGGDDGDDAAAAAAAAAAAAAAAADGGGGDGGGGGGG
JJJJJJJJJGGGGGDAAAAAAAAAAAAAAAAAAAAAADDGDDDGGGGGGG
JJJJJJJGGGGGGDAAAAAAAAAAAAAAAAAAAAAAAADDDAADDGGGGG
GGGGGGGGGGGGGDAAAAAAAAAAAAAAAAAAAAAAAAAAAAADDDGGGG
GGGGGGGGGGGGGAAAAAAAAAAAAAAAAAAAAAAAADAAADDDDGGGGG
GGGGGGGGGGGGGAAAAAAAAAAAAAAAAAAAAAAAAADAADDGGGGGGG
GGGGGGGGGGGGGDAAAAAAAAAAAAAAAAAAAAAAADDDDGGGGGGGGG
GJJJJGGGGGGGGDAAAAAAAAAAAAAAAAAAAAAAADDDDGGGGGGGGG
GJJJJGGGGGGGGDAAAAAAAAAAAAAAAAAAAAAADDDDDGGGGGGGGG
GJJJJJGGGGGGDAAAAAAAAAAAAAAAAAAAAAAADGGGGGGGGGGGGG
GJJJJJJGGGGGDDAAAAAAAAAAAAAAAAAAAAAADGGGGGGGGGGGGG
JJJJJJJGGGGGGGDDAAAAAAAAAAAAAAAAAAAADDDGGGGGGGGGGG
JJJJJJJGGGGGGGGGAAAAAAAAAAAAAAAAAAAAAADDDGGGGGGGGG
JJJJJJJGGGGGGGGGDAAAAAAAAAAAAAAAAAAAAADDDGGGGGGGGG
JJJJJJJGGGGGGGGGDAAAAAAAAAAAAAAAAAAAAAADGGGGGGGGGG
JJJJJJJGGGGGGGGGDAADDDDDAAAAAAAAAAAAAAAADGGGGGGGGG
GJGGJJJGGGGGGGGGDADDGGGGDDDAAAAAAAAAAAAADGGGGGGGGG
GGGGGGGGJGGGGGGGGGGGGGGGGDDDDAAAAAAAAAADDGGGGGGGGG
GGGGGGGGJGGGGGGGGGGGGGGGGGGDDAAAAAAAAADDGGGGGGGGGG
GGGGJJJJJJGGGGGGGGGGGGGGGGGDDAAAAAAAAAADGGGGGGGGGG
GGGGJJJJJJJJGGGGGGGGGGGGGGGGDDAAAAAADADDDGGGGGGGGG
GGGGGJJJJJJJJJJJJGGGGGGGGGGDDDDAAAAADDGGGGGGGGGGGG
GJJJGJJJJJJJJJJJJJGGGGGGGGGGGGDDDDAADDDGGGGGGGGGGG
GJJGJJJJJJJJJJJJJJGGGGGGGGGGGGGGGDDGDGGGGGGGGGGGGG
GGGJJJJJJJJJJJJJJJGGGGGGGGGGGGGGGGGGGGGGGGGGGGGGGG
GGGGJJJJJJJJJJJJJGGJJGGGGGGGGGGGGGGGGGGGGGGGGGGGGG
GGGGGJJJJJJJJJJJJJJJJGJJJJGGGGGGGGGGGGGGGGGGGGGGGG
GGGJJJJJJJJJJJJJJJJJJJJJJJJJJGGGGGGGGGGGGGGGGGGGGG
JJGJJJJJJJJJJJJJJJJJJJJJJJJJJJGGGGGGGGGGGGGGGGGGGG
JJGJJJJJJJJJJJJJJJJJJJJJJJJJJJGGGGGGGGGGGGGGGGGGGG
JJJJJJJJJJJJJJJJJJJJJJJJJJJJJGGGGGGGGGGGGGGGGGGGGG
JJJJJJJJJJJJJJJJJJJJJJJJJJJJJGGGGGGGGGGGGGGGGGGGGG
JJJJJJJJJJJJJJJJJJJJJJJJJJJJJGGGGGGGGGGGGGGGGGGGGG
JJJJJJJJJJJJJJJJJJJJJJJJJJJJJJGGGGGGGGGGGGGGGGGGGG
JJJJJJJJJJJJJJJJJJJJJJJJJJJJJJJJJJJGGGGGGGGGGGGGGG
JMJJJJJJJJJJJJJJJJJJJJJJJJJJJJJJJJJGGGGGGGGGGGGGGG
JJJJJJJJJJJJJJJJJJJJJJJJJJJJJJJJJJJGGGGGGGGGGGGGGG
JJJJMJJJJJJJJJJJJJJJJJJJJJJJJJJJJJJGGGGGGGGGGGGGGG
MMMMMMJJJJJJJJJJJJJJJJJJJJJJJJJJJJJGGGGGGGGGGGGGGG
PMMMMMJJJJJJJJJJJJJJJJJJJJJJJJJJJJJJGGGGGGGGGGGGGG
PPMJJJMMMMMJJJJJMJJJJJJJJJJJJJJJJJJJGGGGGGGGGGGGGG
PPMJMMJMMMMJJJJMMMMJJJJJJJJJJJJJJJJJGGGGGGGGGGGGGG
PPPMMJMJMMMMMJJJJMMMJJJJJJJJJJJJJJJJGGGGGGGGGGGGGG
PPPPJPPMMMMMMMMMJJJJJJJJJJJJJJJJJJJJGGGGGGGGGGGGGG
MMPPMPPMMMMMMMJJJJJJJJJJJJJJJJJJJJJJJGGGJGJJGJGGGG
PPPPPPPPMMMMMJJJJJJJJJJJJJJJJJJJJJJJJJJJJJGJJJJGJG
PPPPPPPPMMMMMJJJJJJJJJJJJJJJJJJJJJJJJJJJJJJJJJJJJJ
PPPPPPPMMMMMMJJJJJJJJJJJJJGJJJJJJJJJJJJJJJJJJJJJJJ
PPPMPPPPMPPMMMJMJJMJJJJJJJJJJJJJJJJJJJJJJJJJJJJJJJ
PPPPPPPMPPMMMMMJMJMJJJJJJJJJJJJJJJJJJJJJJJJJJJJJJJ
