PPPPPPPPPPPPPPPMMMMMPPPPMMMMMMJJMMMMMMMMMMMJJJJJJJ
PMPPPPPPPPPPPPMPPPMPPPMPPPMMMMMMMMMMJMMMMMMJJJJJJJ
PMPPPPPPPPMPPPMPPPPPPPPPPPPMMMMMMMMJMJMMMMMJJJJJJG
PPPPPPPPPPMPMMMPPPPPPPPPPPPPPMMMMMJJJJJJJJJJJJJJJG
MPPPPPPPPPPMMPPMPPPPPPPPPPPPMMJJMJJJMJJJJJJJJJJJJG
MMPPPPPPPPMPMPMMPPPPPPPPPPPMMMMMJJJJJJJJJJJJJJJJJG
PPPPPPPPPPPMMPMJMMMPPPPPPPPPMMMMMMJJJJJJJJJJJJJJJJ
PPPPPPPPPPPMMJMMMMMMMMPPPPPPMMMMMJMJJJJJJJJJJJJJJJ
PMPMPPPPPPPMPPMMJMMJMMMMMPPMMMMMMMJJJJJJJJJJJJJJJJ
MPPPPPPPPPMMMMMMJMMJMMMMMPMMJJJMJJJJJJJJJJJJJJJJJJ
PPPPPPPPPPPPMMMJJJMMMMMMPPMMJJJJJJJJJJJJJJJJJJJJJJ
MPMPPPMMPPMMMPJJMJMMJMMMMMMMJJJJJJJJJJJJJJJJJJJJJJ
MPMPPPPMPPMMMMMJJMMMMJJMMMMMJMJJJJJJJJJJJJJJJJJJJJ
MMPMPPPMPMMMMMMJJJJMJJJJMMMJJJJJJJJJJJJJJJJJJJJJJJ
MMMMMMPMMMMJJMMJJJJJJJJJJJJJJJJJJJJJJJJJJJJJJJJJJJ
MJMJMMMPMJJMJMJJJJJJJJJJJJJJJJJJJJJJJJJJJJJJJJJJJJ
JMMMMMMPMMMMJMJJJJJJJJJJJJJJJJJJJJJJJJJJJJJJJJJJJG
JMMMMMMPPPMPMMJJJJJJJJJJJJJJJJJJJJJJJJJJJJJJJJJGGG
JJMMMMMPMPMMMJJJJJJJJJJJJJJJJJJJJJJJJJJJJJJJJGGGGG
JJJJJMMMMMMMMJJJJJJJJJJJJJJJJJJJJJJJJJJJJJJJJGGGGG
JJJJJJJMMMMJMMJJJJJJJJJJJJJJJJJJJJJJJJJJJJJJJJGGGG
JJJJJMJJMJJJJJJJJJJJJJJGGJJJJJJJJJJJJJJJJJJJJJGGGG
JJJJJJJJJJJJJJJGGJGGGJJGJJJJJJJJJJJJJJJJJJJJJJGGGG
JJJJJJJJJJJJGGGGGGGGGGGGGJJJJJJJJJJJJJJJJJJJJJJGGG
JJJJJJJJJJJGGGGGGGGGGGGGGJJJJJJJJJJJJJJJJJJJJJJJGG
JJJJJJJJJGJGGGGGGGGGGGGGGGJJJJJJJJJJJJJJJJJJJJJJGG
GGGGGGGGGJJJGGGGGGGGGGGGGJJJJJJJJJJJJJJJGJJJJJJGGG
GGGGGGGGJJJGGGGGGJGGGGGGGGJJJJJJJJJJJJJJJGGJJGGGGG
GGGGGGGGGJJGGGGGJJJGGGGGGGJJJJJJJJJJJJJJJGGGGGGGGG
GGGGGGGGGJGGGGGJJJJJGJGGGGGJJJJJJJJJJJJJJGGGGGGGGG
GGGGGGGGJJJJGGGJJJJJJJGGGGGJJJJJJJJJJJJJJJGGGGGGGG
GGGGGGGGGJJJJGGJJJJJGGGGGGGGGJJJJJJJJJJJJJGGGGGGGG
GGGGGGGJGJJJJJJJJJJJGGGGGGGGGJJJJJJJJJJJJJGGGGGGGG
GGGGGGGJJJJJJJJGGGGJGGGGGGGGGGJJGGJJGGJJJGGGGGGGGG
GGGGGGGJJJJJJJJGGGGGGGGGGGGGGGGGGGGGGGGGGGGGGGGGGD
GGGGGGGJJJJJJJJGGGGGGGGGGGGGGGGGGGGGGGGGGGGGGGGGDA
GGGGGGGJJJJJJJGGGGGGGGGGGGGGGGGGGGGGGGGGGGGGGGGGDA
GGGGGGGJJJJJJJGGGGGGDDDDDDGGGGGDDDGGGGGGGGGGGGGGDA
GGGGGGGGGJJJGJGGGGGDDDADDDDDDGDDDDDGGGGGGDDDDDDDDA
GGGGGGGGGJJGGGGGGGGGDAAAAAAAAAADDDDDGGGGGDAAAAADDA
GGGGGGGGGGGGGGGGGGGDAAAAAAAAAAADGDDGGGGGDAAAAAAAAA
GGGGGGGGGGGGGGGGGGGDAAAAAAAAAAAADGGGGGDDAAAAAADDAA
GGGGGGGGGGGGGGGGGGGDAAAAAAAAAAADDDDGGDDDAAAAAAAAAA
GGGGGGGGGGGGGGGGGGGDAAAAAAAAAAADGDDDDDAAAAAAAAAAAA
GGGGGGGGGGGGGGGGGGGAAAAAAAAAAAADDDDDDDDAAAAAAAAAAA
GGGGGGGGGGGDDGGGGGAAAAAAAAAAAAADDAAAAAADDAAAAAAAAA
GGGGGGGGGGDDDDGGGDAAAAAAAAAAAAAAAAAAAADDDDDAAAADDD
GGGGGGGDGGDDDDDDGDAAAAAAAAAAAAAAAAAAAADDDGDDADDDDD
GGGGGGGGDDDDDDDDDDAAAAAAAAAAAAAAAAAAADGGDGGGGDDDGG
GGGGGGGGDDDDDDDAAAAAAAAAAAAAAAAAAAAAADGGGGGGGGGGGG
