GGGGGGGGGGGGGGGGGGGGGGGGGGGGGGGGGGJJGGGGGGGGGGGGGG
GGGGGGGGGGGGGGGGGGGGGGGGGGGGGGGGGGJJJGGGGGGGGGGGGG
GGGGGGGGGGGGGGGGGGGGGGGGGGGGGGGGGJJJJJGGGGGGGGGGGG
GGGGGGGGDGGDGGGGGGGGGGGGGGGGGGGGJJJJJJJGGJGGGGGGGG
GGGGGGGDDDDDGGGGGGGGGGGGGGGGGGGJJJJJJJJJJJGJGGGGGG
GGGGGGGDAADDGGGGGGGGGGGGGGJJGGJJJJJJJJJJJJJGJJGGGG
GGGGGGGAAAAADDDDDDDGGGGGGGJJJJJJJJJJJJJJJJJJJJJJGG
GGGGGGGAAAAAAAADDDDGGGGGGGJJJJJJJJJJJJJJJJJJJJJJGG
GGGGGGGDAAAAAAAADDGGGGGGGGJJJJJJJJGGJJJJJJJJJJJJJJ
GGGGGGGDAAAAAAAAAADGGGGGGGJJGGGGGGGGGJJJJJJJJJJJJJ
GGGGGGDAAAAAAAAAAAADDGGGGGGGGGGGGGGGGGJJJJJJJJJJJJ
GGGGGDDAAAAAAAAAAAAAADGGGGGGGGGGGGGGGGGJJJJJJJJJJJ
GGGGGDAAAAAAAAAAAAAADGGGGGGGGGGGGGGGGGGJJJJJJJJJJJ
GGGGDAAAAAAAAAAAAAAAAGGGGGGGGGGGGGGGGGGJJJJJJJJJJJ
GGGGAAAAAAAAAAAAAAAADGGGGGGGGGGGGGGGGGJJJJJJJJJJJJ
GGGDAAAAAAAAAAAAAAAADGGGGGGGGGGGGGGGGGJJJJJJJJJJMJ
GGGDAAAAAAAAAAAAAAADGGGGGGGGGGGGGGGGGGJJJJJJJJJJMJ
GDDAAAAAAAAAAAAAAAAADGGGGGGGGGGGGGGGGGJJJJJJJJJJMJ
DDAAAAAAAAAAAAAAAAAADDGGGGGGGGGGGGGGGGGGGJJJJJJJJM
DAAAAAAAAAAAAAAAAAAAADGGGGGGGGGGGGGGGGGGJJJJJJJJJJ
AAAAAAAAAAAAAAAAAAAAAADDGGGGGGGGGGGGGGGGJJJJJJJJMM
AAAAAAAAAAAAAAAAAAAAAADDGGGGGGGGGGGJJGGJJJJJJJJMMM
AAAAAAAAAAAAAAAAAAAAAAAADGGGGGGGGGJJJJJJJJJJJJJJMM
AAAAAAAAAAAAAAAAAAAAAAAAAGGGGGGGGGJJJJJJJJJJJJJMMM
AAAAAAAAAAAAAAAAAAAAAAAAADGGGGGGJJJJJJJJJJJJMMMMPM
AAAAAAAAAAAAAAAAAAAAADADGGGGGGJJJJJJJJMJJJJMMMMMMP
AAAAAAAAAAAAAAAAAAAADGGGGGGJJGGJJJJJJJMJJJMMMMMMMP
AAAAAAAAAAAAAAAAAAADGGGGGGJJJJJJJJJJJJJMMMJMMMPMMP
AAAAAAAAAAAAAAAAADGGGGGGGJJJJJJJJJJJJJMMMMMMMMMPPP
AAAAAAAAAAAAAAAAAGGGGGGJGJJJJJJJJJJJMMMMMMMMPMMMPP
AAAAAAAAAAAAAAAAAGGGGJJJJJJJJJJJJJJMMMMMMMMMPMMPPM
AAAAAAAAAAAAAAAAGGGGJJJJJJJJJJJJJMJJMMMMMMMMMMMMMP
AAAAAAAAAAAAAAADGGGGJJJJJJJJJJJJJMMJMMMMMMMMJMMMPP
AAAAAAAAAAAAADGGGGGGJJJJJJJJJJJJJMJMMMMMJJMMJJJJMM
AAAAAAAAAAAAADDGGGGGGJJJJJJJJJJJJJMMMMMJJJMJJJJJMM
AAAAAAAAAAAADGGGGGGGGJJJJJJJJJJJJJJMMMJJJJJJJJJJJM
AAAAAAAAAAAADGGGGGGGGGJJJJJJJJJJJJJMMMMJMJJJJJJJJJ
AAAAAAAAAAAADGGGGGGGGGGJJJJJJJJJJJJJJMMMMMJJJJJJJJ
DAAAAAAAAAAADGGGGGGGGGGGGJJJJJJJJJJJJJMMMMJJJJJJMJ
DDDDDAAAAAAADDGGGGGGGGGGGJJJJJJJJJJJJJMJMMMMJJJJJJ
GGGGGDDAAAADDGGGGGGGGGGGGGGJJJJJJJJJJJJMMMMMMJJMJJ
GGGGGGGDDAADDGGGGGGGGGGGGGGJJJJJJJJJJJJMMMMMJJMMJJ
GGGGGGGGDAAADDGGGGGGGGGGGGGGJJJJJJJJJJJMMMMMMJJJJJ
DDDGGGGGGDDDDGGGGGGGGGGGGGGGGJJJJJJJJJJMMMMMMJJJJJ
DDDGGGGGGDDDGGGGGGGGGGGGGGGGGJJJJJJJJJJJJJMMMMJJJJ
DDDDDDDDDDDGGGGGGGGGGGGGGGJJJJJJJJJJJJJJJJJJJJJJJJ
DDDDDDDDDDDGGGGGGGGGGGGGGGGJJJJJJJJJJJJJJJJJJJJJJJ
DDDDDDDDDDGGGGGGGGGGGGGGGGJGGGJJJJJJJJJJJJJJJJMJJJ
DDDDDDDDDDGGGGGGGGGGGGGGGGJGGGJJJJJJJJJJJJJJJMMJMM
DDDDDDDDDDGGGGGGGGGGGGGGGJGGGGJJJJJJJJJJJJJJJMMJMM
