GGGGJJJJJGGJJJJJJJJJJJJJJJJJJJJJGGGGJGGJJGGGGGGGJJ
GGGJJJJJJJJJJJJJJJJJJJJJJJJJJJJGGGGGGGGGGGGGGGGGJJ
JJJJJJJJJJJJJJJJJJJJJJJJJJJJJJJJGGGGGGGGGGGGGGGGGG
JJJJJJJJJJJJJJJJJJJJJJJJJJJJJJJGGGGGGGGGGGGGGGGGGG
JJJJJJJJJJJJJJJJJJJJJJJJJJJJJJJGGGGGGGGGGGGGGGGGGG
JJJJJJJJJJJJJJJJJJJJJJJJJJJJJJJJGGGGGGGGGGGGGGGGGG
JJJJJJJJJJJJJJJJJJMJJJJJJJJJJJJGGGGGGGGGGGGGGGGGGG
JJJJJJJJJJJJJJJJJJJJJJJJJJJJJJGGGGGGGGGGGGDGGDADDG
JJJJJJJJJJJJJMMMMMMMJJJJJJJJJJJGGGGGGGDDDDADAAADDG
JJJJJJJJJJJJMMMMMMMJJJJJJJJJJJJJGGGGDDDAAAAAAAAADG
GGJJJJJJJJJMMMMMMMMMJJJJJJJJJJJJGGGDDDAAAAAAAAAADD
GGGJJJJJJJMMMMMMMMMMJJJJJJJJJJJGGGGGDDAAAAAAAAAADD
GGGJJJJJJMJMMMMMMMMMMJJJJJJJJJGGGGGGDAAAAAAAAAAAAD
GGGJJJJJJMMMMMMMMMMMMJJJJJJJJGGGGGGGAAAAAAAAAAAAAA
GGGJJJJJMMMMMMMMMMMMJJJJJJJJJGGGGGGDAAAAAAAAAAAAAA
GGGGJJJJJJMMMMMMMMMJJJJJJJJJJGGGGGGDAAAAAAAAAAAAAA
GGGJJJJJJMMMMMMMMMMMJJJJJJJJJGGGGGGDAAAAAAAAAAAAAA
GGGJJJJJMMMMMMMMMMMMJJJJJJJJGGGGGGGDAAAAAAAAAAAAAA
GJJJJJMMMMMMMMMMMMMJJJJJJJJJGGGGGGGDDAAAAAAAAAAAAA
GJJJJJJMMMMMMMMMMMMJJJJJJJJGGGGGGGDDDAAAAAAAAAAAAA
JJJJJJJMMMMMMMMJMJMJJJJJJGGGGGGGGGGDDAAAAAAAAAAAAA
JJJJJJJJMMMMMMMJMMJJJJJJGGGGGGGGGGGDDAAAAAAAAAAAAA
JJJJJJJJMMMMMMMJMJJJJJJGJGGGGGGGGGGGGDDAAAAAAAAAAA
JJJJJJJJMMMMJMMMMJJJJJJJJJGGGGGGGGGGGGGDDAAAAAAAAA
JJJJJJJJJMMMMMMJJJJJJJJJJJGGGGGGGGGGGGGGDAAAAAAAAA
JJJJJJJJJJMMMJMJJJJJJJJJJJGGGGGGGGGGGGGGDDADAAAAAA
JJJJJGJJJJJJJJJJJJJJJJJJJGGGGGGGGGGGGGGGDDDDAAAAAA
JJJJGGJJJJJJJJJJJJJJJJJJJGGGGGGGGGGGGGGGDAAAAAAAAD
GGGGGGJJJJJJJJJJJJJJJJJJJGGGGGGGGGGGGGGGDDAAAAADDG
GGGGGGGGJJJJJJJJJJJJJJJJGGGGGGGGGGGGGGGGGDDDAADGGG
GGGDGGGGGGJJJJJJJJJJJJJJGGGGGGGGGGGGGGGGGDDDGGGGGG
GGDADGGGGGJJGJJJJJJJJJJJGGGGGGGGGGGGGGGGGGDGGGGGGG
GGAAADDDGGGGGJJJJJJJJJJJJGGGGGGGGGGGGGGGGGGGGGGGGG
DAAAAAAAGGGGGJJJJJJJJJJJJJGGGGGGGGGGGGGGGGGGGGGGGG
AAAAAAAADDGGGGJGJJJJJJJJJJGGGGGGGGGGGGGGGGGGGGGGGG
AAAAAAAADDGGGGGGGGGGJGJJJGGGGGGGGGGGGGGGGGGGGGGGGJ
AAAAAAAADDDDGGGGGGGGGGGGGGGGGGGGGGGGGGGGGGGGGGGGJJ
AAAAAAAAADADGGGGGGGGGGGGGGGGGGGGGGGGGGGGGGGGGGJJJJ
AAAAAAAAAAAAADDDDDDDDDGGGGGGGGGGGGGGGGGGGGGGGGJJJJ
AAAAAAAAAAAAAAAAAAAAAADGGGGGGGGGGGGGGGGGGGGGGGGGGJ
AAAAAAAAAAAAAAAAAAAAAAAADDADDGGGGGGGGGGGGGGGGGGGGJ
DAAAAAAAAAAAAAAAAAAAAAAAAAAADGGGGGGGGGGGGGGGGGGGGG
GDAAAAAAAAAAAAAAAAAAAAAAAAAADGGGGGGGGGGGGGGGGGGGGG
GDDAAAAAAAAAAAAAAAAAAAAAAAAADGGGGGGGGGGGGGGGGGGGGG
GDDAAAAAAAAAAAAAAAAAAAAAAAAADGGGGGGGGGGGGGGGGGGGGG
DDAAAAAAAAAAAAAAAAAAAAAAAAAADGGGGGGGGGGGGGGGGGGGGG
DAAAAAAAAAAAAAAAAAAAAAAAAAAADGGGGGGGGGGGGGGGGGGGGG
DAAAAAAAAAAAAAAAAAAAAAAAAAAADGGGGGGGGGGGGGGGGGGJJJ
AAAAAAAAAAAAAAAAAAAAAAAAAAAADDDGGGGGGGGGGGGGGGGJJJ
AAAAAAAAAAAAAAAAAAAAAAAAAAAAAADDDGGGGGGGGGGGGGGJJJ
