JMMMMMMMMMMMMMMMMMMMMJJJJJJJJGGGGGGGGDDDDAAAAAAAAA
MMMMMMMMMMMMMMMMMMMMMJJJJJJJJGGGGGGGGDDDDDAAAAAAAA
MJMMMMMMMMMMMMMMMMMMMMJJJJJJGGGGGGGGGDDDGGDDAAAAAA
JJJMMMMMMMMMMJMMMMMMMMJJJJJJGGGGGGGGGDDDGGDDAAAAAA
JJJJJMMJJJMJMMMJMMMMMJJJJJJJGGGGGGGGDDDDGDDDAAAAAA
JJJJJJJJMMMMMMMMMMMMJJJJJJJJGGGGGGGGDGDGGGDDAAAAAA
JMJJJJJJMMJMMMMMMMJJJJJJJJJJGGGGGGGGDDGGGGDAAAAAAA
MMMMJJJMJJMJMMMMJJJJJJJJJJJGGGGGGGGGGDGGDDAAAAAAAA
JJJJMJJJJJMMMMMJJJJJJJJJJGGGGGGGGGGGGGGGDAAAAAAAAA
JMJJJJJJJJMMMMMJJJJJJJJJJGGGGGGGGGGGGDDDAAAAAAAAAA
JMMJJJJJJMMMMMJJJJJJJJJJGGGGGGGGGGGGGDDAAAAAAAAAAA
JMJJJJJJMMMMMMMJJJJJJGGGGGGGGGGGGGGDAAAAAAAAAAAAAA
MMJJJJJJJJMMMMMJJJJJJGGGGGGGGGGGGDAAAAAAAAAAAAAAAA
MJJJJJJJJJMMMMJJJJJJGGGGGGGGGGGGDDAAAAAAAAAAAAAAAA
JJJJJJJJJJMMMJJJJJJJGGGGGGGGGGGGDAAAAAAAAAAAAAAAAA
JJJJJJJJJJMMMJJJJJJJGGGGGGGGGGDDDAAAAAAAAAAAAAAAAA
JJJJJJJJJJJMMJJJJGGGGGGGGGGGGDAAAAAAAAAAAAAAAAAAAA
JJJJJJJJJJJMJJJJJGGGGGGGGDDDDAAAAAAAAAAAAAAAAAAAAA
JJJJJMJJJJJJMJJJJGGGGGDDDDDDAAAAAAAAAAAAAAAAAAAAAA
JJJJJMJMJJMMMMJJJGGGDDADDAAAAAAAAAAAAAAAAAAAAAAAAA
JJJJJJJMJJMMMMJJJGGGDAAAAAAAAAAAAAAAAAAAAAAAAAAAAA
JJJJMJJMMJMMJJJJJGGDAADAAAAAAAAAAAAAAAAAAAAAAAAAAA
JMMMMMMJJJJMMJJJJJGGAAAAAAAAAAAAAAAAAAAAAAAAAAAAAA
MMMMMMMMJJJMJJJJJJGGAAAAAAAAAAAAAAAAAAAAAAAAAAAAAA
MMMMMMJMJJJJJJJJJGGGGDAAAAAAAAAAAAAAAAAAAAAAAAAAAA
MMMMMMJMJJJJJJJJJGGGGDDAAAAAAAAAAAAAAAAAAAAAAAAAAA
MMMJMMJJJJJJJJJJJJGGGGGDAAAAAAAAAAAAAAAAAAAAAAAAAA
MMJJJJJJJJJJJJJJJJJJGGGGDAAAAAAAAAAAAAAAAAAAAAAAAA
MJJJJJJJJJJJJJJJJJJJJGGGGDDAAAAAAAAAAAAAAAAAAAAAAA
JJJJJJJJJJJJJJJJJJJJJJGGGGGDADDAAAAAAAAAAAAAAAAAAA
JJJJJJJJJJJJJJJJJJJJJJJGGGGGGGGDAAAAAAAAAAAAAAAAAA
JMMMJJJJJJJJJJJJJJJJJJJJGGGGGGGGAAAAAAAAAAAAAAAAAA
JMJMJMJMJJJJJJJJJJJJJJJJGGGGGGGGDDDDDAAAAAAAAAAAAA
JMMJJJJJJJJJJJJJJJJJJJJJJGGGGGGGGGGGGDAAAAAAAAAAAA
MMJJJJJJJJMMMMJJJJJJJJJJJGJJGGGGGGGGGDDAAAAAAAAAAA
MMJJJJJJJJMMMJJJJJJJJJJJJGGGGGJGGGGGGGGDDAAAAAAAAA
JJJJJJMJMJMMMJJJJJJJJJJJJJJJGJJGGGGGGGGGGDAAAAAAAA
JJJJJMJJJJJJJJJJJJJJJJJJJJJGGJJJJJGGGGGGGDAAAAAAAA
JJJJJJJJJJJMJJJJJJJJJJJJJJJGGGJJJJJGGGGGGDDAAAAAAA
JJJJJJJJJJJMMJJJJJJJJJJJJGGGGJJJJJGGGGGGGGGDAAAAAA
MJJJJJMJJJJJMJJJJJJJJJJJJGGGJJJJJJGGGGGGGGGGAAAAAA
JJJJJJMJJJJJJJJJJJJJJJJJJGGGJJJJJJGGGGGGGGGGDAAAAA
JJJJJJJJJJJJJJJJJJJJJJGJJJJGGJJJJJGGGGGGGGGGDDADDD
JJJJJJJJJJJJJJJJJJJJJGJJJJJJJJJJJJGGGGGGGGGGGGGDGG
JJJJJJJJJJJJJJJJJJJJJJJJJJJJJJJJJJGGGGGGGGGGGGGGGG
JJJJJJJJJJJJJJJJJJJJJJJJJJJJJJJJJGGGJGGGGGGGGGGGGG
JJJJJJJJJJJJJJJJJJJJJJJJJJJJJJJJJJJJJJJGGGGGGGGGGG
JGGJJJJJJMJJJJJJJJJJJJJJJJJJJJJJJJJJJJJJGGGGGGGGGG
JJJJJJJJJJJJJJJJJJJJJJJJJJJJJJJJJJJJJJGGGGGGGGGGGG
JJJJJJJJJJJJJJJJJJJJJJJJJJJJJJJJJJJJJGGGGGGGGGGGGG
