AAAAAAAAAAAAAAAAADDDDAADDDDDDDDDDDDDDDDDDGGGGGGGGG
AAAAAAAAAAAAAAAAADDGDDADGGGDDDDDDDDDDDDDDDDDGGGGGG
AAAAAAAAAAAADADDAADDDDDDGGGGGDDDDDDDDDDDDDDDGGGGGG
AAAAAAAAAAAAAAAAAADDDGGGGGGGGGGGGGDDDDDDDDDDGGGGGG
AAAAAAAAAAAAAAAAAADDDGGGGGGGGGGGGGGDDDDDDDDGGGGGGG
AAAAAAAAAAAAAAAAAADDGGGGGGGGGGGGGGGDDDDDDDGGGGGGGG
AAAAAAAAAAAAAAAAAAGGGGGGGGGGGGGGGGGGGDDDGGGGGGGGGG
AAAAAAAAAAAAAAAAADGGGGGGGGGGGGJJJJGGGGGGGGGGGGGGGG
AAAAAAAAAAAAAAAAADGGGGGGGGGGJJJJJJJJGGGGGGGGGGGGGG
AAAAAAAAAAAAAAAADDGGGGGGGGGGJJJJJJJJJGGGGGGGGGGGGG
AAAAAAAAAAAAAAAGGGGGGGGGGGGJJJJJJJJJJJGGGGGGGGGGGG
AAAAAAAAAAAAAAAGGGGGGGGGGGJJJJJJJJJJJJGGGGGGGGGGGG
AAAAAAAAAAAAAADGGGGGGGGGJJJJJJJJJJJJJJGGGGGGGGGGGG
AAAAAAAAAAAAAAADGGGGGGGJJJJJJJJJJJJJJJJJGGGGGGGGGG
AAAAAAAAAAAAAAAAADDGGGJJJJJJJJJJJJJJJJJJJGGGGGGGGG
AAAAAAAAAAAAAAAAAADGGGJJJJJJJJJJJJJJJJJJJGGGGGGGGG
AAAAAAAAAAAAAAAAAADGGJJJJJJJJJJJJJJJJJJJGGGGGGGGGG
AAAAAADDAAAAAAAAAADGGJJJJJJJJJJJJJJJJJJJJGGJJGGGGG
AAAAADAAAAAAAAAAAADGGJJJJJJJJJJJJJJJJJJJJJJJJGGGGJ
AAAAADAAAAAAAAAAAADGGJJJJJJJJJJJJJJJJJJJJJJJJJJJJJ
AAAAAAAAAAAAAAAAADGGGGJJJJJJJJJJJJJJJJJJJJJJJJJJJJ
AAAAAAAAAAAAAAAAAAGGGJJJJJJJJJJJMJJJJJJJJJJJJJJJJJ
AAAAAAAAAAAAAAAAADDGGGGGJJJJJJMMJJJJJJJJJJJJJJJJJJ
DAAAAAAAAAAAAAAADDGGGGGJJJJJJJMMMJJJJJJJJJJJJJJJJJ
AAAAAAAAAAAAAAADGGGGGGGJJJJJJJMJJMJJJJJJJJJJJJJJJJ
DAAAAAAAAAAAAAADDGGGGGGJJJJJJJJMJJJJJMJJJJJJMJJJJJ
DDDAAAAAAAAAAAADDDGGGGGJJJJJJJMMJJMMMJJJJJJJJJJJJJ
DDDAAADAAAAAAAADDDDGGGGJJJJJJMMMJJMMJMMJJJJJJJJJJJ
DDDDDDAAAAAAAADGDGGGGGGJJJJJMMMMMMMMMMJMMMMMMMJJJJ
GGGDDDAAAAADDGGGGGGGGJJJJJJMMMMMJMMJJJMJMMJMMMMJJJ
GGGGDDDDGGDDGGGGJJJGJJJJJJJMMMMMMMMMMMJMMMMMMMMMMM
GGGGGGGGGGGGGGGJJJJGJJJJJMMMMMMMMMMMMMMMMJMMMMMMJJ
GGGGGGGGGGGGGJJJJJJJJJJJMMPPPPPMJMPMMPMMMMMMMPPMMM
GGGJJJGGGJJJJJJJJJJJJJJJMMPPPPPMMMMMPPMMMMMPPPPMMM
GJJJJJJJJJJJJJJJJJJJJJJJMPPPPPPMMPPPPPPMMMMPPPPMPP
GJJJJJJJJJJJJJJJJMJJJJMMMMPPPPPPMPPPPPPMMMMPPPMMPP
GJJJJJJJJJJJJJMMMMMJMMMMMPPPPPPMPPPMMMMPPMMPPPPPMP
JJJJJJJJJJJJJMMMMMMMMMMMPMMMPPMPPPPMPPPPPPPMPPPPPP
JJJJJJJJJJJJMMMMMMMMMMMMPMMPMPMMMMMMPMPPPPPPPPPPPP
JJJJJJJJJMMMMMMMMMMMMMJMMJMPMMMMJMMMMMPPPPPPPMPPPP
JJJJJJJJJJMMMMMMJJMMPMMJJMMMMJJJJJMMMPPPPPPPPMPPPP
JJJJJJJMMJMMMMMJJMMMPMMJMMMJMJJJJMPPPPPPPPPPPPPPPP
JJJJJJJMMJMMMMMMJMMMMMJJMJJJJJJJJPPPPPPPPMPPPPPPMM
JJJJJJJJJJMMMMMMMMMPMMJMJMMJJJMJMMPPPMPPMPPPPPPPPM
JJJJJJJJJMMMJMMMMMPPPMMMMJJMJJMMJMPPMPPMPPPPPPPPMJ
JJJJJJMJMMMJJMJJJJMPPPPMMJJJJJJMJMMMJMJPPPPPPPPPPM
JJJJJJJMJMJJMMJJJMMPPPMMMMMJJJJMMJJMMMMPPPPPPMMMMP
JJJJJJJJJJJMJJJJMMMPPPMMMJMJJJMJJJJMMPPMPPPPPPMPMP
JJJJJJJJJJJJJJJMMMMMPPMMMMJJMMMMJMMPMMPPPPPMPMMJJM
JJJJJJJJJJMJJJJJMJMMMMMMMMMJJJMMMMPMMMPPPPMMMMMMJJ
