JJJMJJJMJJJJJJJJJJJJJJJJJJJJJJJJJJJJJJJJJJJJJJJGGG
JJJJJJMMJJJJJJJJJJJJJJJJJJJJJJJJJJJJJJJJJJJJJJGGGG
JJJJMJMMJMJJJJJJJJJJJJJJJJJJJJJJJJJJJJJJJJJJJGGGGG
JJJJJJJJJJJJJJJJJJJJJJJJJJJJJJJJJJJJJJJJJJJJJJGGGG
JJJJJJJJJMJJJJJJJJJJJJJJJJJJJJJJJJJJJJJJJJJJJJJGGG
JJJJJJJMMMJJJJJJJJJJJJJJJJJJJJJJJJJJJJJJJJJJJJGGGG
JJJJJJMMMJJJJJJJJJJJJJJJJJJJJJJJJJJJJJJJJJJJJJJGGG
JJJJJJMMJJJJJJJJJJJJJJJJJJJJJJJJJJJJJJJJJJJJJJJJGG
JJJJJJJJJJJJJJGGGJJJJJJJJJJJJJJJJJJJJJJJJJJJJJJJGG
JJJJJJJJJJJJJJGGGGJJJJJJJJJJJJJJJJJJJJJJJJJJJJJJGG
JJJJJJJGJJJJJGGGGGGJJJJJJJJJGJJJJJJJJJJJJJJJJJJJJJ
JJJJGGGGGGGGGGGGGGGGJJGGGGJGJJJJJJJJJJJJJJJJJJJJJJ
GGGGGGGGGGGGGGGGGGGGGGGGGGGGGJJJJJJJJJJJJJJJJJJJJJ
GGGGGGGDDGGGGGGGGGGGGGGGGGGGGJJJJJJJJJJJJJJJJJJJGG
GGGGGGGDDDDGGGGGGGGGGGGGGGGGJJJJJJJJJJJJJJJJJJJJGG
GGGGGGDDDDDDDDGGGGGGGGGGGGGGJJJJJJJJJJJJJGJJJJJJGG
GGGGGDDDDDGGDDGGGGGGGGGDGGGGGGJJJJJGJJJJJGGGJJGGGG
GGGGGDADDDDGDDGGGGGGDGDDDDDGGGGGJJGGGJJJGGGGGGGGGG
GGGDDDAAAADDDDDDDADDDAAAADDGGGGGGGGGGGGGJGGGGGGGGG
GGGDAAAAAAAAAAAAAAAAAAAADDDGGGGGGGGGGGJJJJJJGJJGGG
GGGGDDDAAAAAAAAAAAAAAAAAADDDDGGGGGGGGJJJJJJGGGGGGG
GGGGGGGDAAAAAAAAAAAAAAAAADDAADGGGGGGGJJJJJJGGGGGGG
GGGGGGDAAAAAAAAAAAAAAAAAAAAAAADGGGGGGJJJGGGGGGGGGG
GGGGGDAAAAAAAAAAAAAAAAAAAAAAAAADGGGGGGGGGGGGGGGGGG
GGGDDDAAAAAAAAAAAAAAAAAAAAAAAAADDGGGGGGGGGGGGGGGGG
GGGDDAAAAAAAAAAAAAAAAAAAAAAAAAADDDGGGGGGGGGGGGGGGG
GGGDDAAAAAAAAAAAAAAAAAAAAAAAAAADDDGGGGGGGGGGGGGGGG
GDDDAAAAAAAAAAAAAAAAAAAAAAAAAAADDGGDDDDGGGGGGGGGGG
DDAAAAAAAAAAAAAAAAAAAAAAAAAAAAAADDDDADDDGGGGGGGGGG
DDAAAAAAAAAAAAAAAAAAAAAAAAAAAAAAAAAAAAAAGGGGGGGGGG
DDAAAAAAAAAAAAAAAAAAAAAAAAAAAAAAAAAAAAAADGGGGGGGGG
DDAAAAAAAAAAAAAAAAAAAAAAAAAAAAAAAAAAAAAADDGGGGGGGG
DAAAAAAAAAAAAAAAAAAAAAAAAAAAAAAAAAADAAADDDGGGGGGGG
AAAAAAAAAAAAAAAAAAAAAAAAAAAAAAAAADDDDAADGGGGGGGGJJ
ADAAAAAAAAAAAAAAAAAAAAAAAAAAAAAADDDGGDGGGGGGGGGJJJ
DDDAAAAAAAAAAAAAAAAAAAAAAAAAAAAADDDDDGGGGGGGJJJJJJ
DDDAAAAAAAAAAAAAAAAAAAAAAAAAAAAADGDDDGGGGGGGJJJJJJ
GGDDAAAAAAAAAAAAAAAAAAAAAAAAAAADDGDDGGGGGGJJJJJJJJ
GGGDAAAAAAAAAAAAAAAAAAAAAAAAAAADDGGGGGGGGJJJJJJJJJ
GGGDAAAAAAAAAAAAAAAAAAAAAAAAAADGGGGGGGGJJJJJJJJJJJ
GGGDDAAAAAAAAAAAAAAAAAAAAAAAADGGGGGGJGJJJJJJJJJJJJ
GGGDDAAAAAAAAAAAAAAAAAAAAAADDDGGGGGJJJJJJJJJJJJJJJ
GGGGDDAAAAAAAAAAAAAAAAAAADGGGGGGGGGJJJJJJJJJMMMMJJ
GGGGDDDAAAAAAAAAAAAAAAAADGGGGGGGJJJJJJJJJJJJMMMMMJ
GGGGDDAAAAAAAAAAAAAAAAADGGGGGGJJJJJJJJJJJJJMMMMMMJ
GGGGDAAAAAAAAAAAAAAAADDDGGGGGJJJJJJJJJJJJMMMMMMMMM
GGGDAAAAAAAAAAAAAAAAADDDGGGGJGJJJJJJJMMJJJMMMMMMMM
GGGDAAAAAAAAAAAAAAAADDGGGGGGJJJJJJJJJMMJJJMMMPMMMM
GGDDAAAAAAAAAAAAAAAADDGGGGGGJJJJJJJJJJMJJJMMMMMMMM
GGDDDAAAAAAAAAAAAAADDGGGGGGGJJJJJJJJJJJJJJMMMMMMMM
